Michael Cusick  	vs.	Majin Bae  	Player 2 Win
Tho Bui  	vs.	Eric LaGaccia  	Player 1 Win
Daniel Link  	vs.	Zack Phillips  	Player 2 Win
Chad McKittrick  	vs.	Daniel Wolff  	Player 2 Win
Mark Chamberlain  	vs.	Michael Stanko  	Player 1 Win
Brandon Salvatore  	vs.	Fernando Caprino  	Player 2 Win
VINAY SONI  	vs.	Justin Matlack  	Draw
Anthony Gascon  	vs.	Devon Conn  	Player 1 Win
Chris Rowland  	vs.	Steven Rodriguez  	Player 2 Win
James Goncalves  	vs.	Ryan Goldfinger  	Player 2 Win
Marc Aubin  	vs.	Alex Tyler  	Player 2 Win
Ted Nilsson  	vs.	Thomas Hood  	Player 2 Win
Gabriel Rasicot  	vs.	jaystin teets  	Player 1 Win
Nicholas McPherson  	vs.	Alex Sneed  	Player 2 Win
James Wray  	vs.	Bryce Kesterson  	Player 1 Win
Roger Bodee  	vs.	Rene Nottingham  	Player 1 Win
Allison Oram  	vs.	Philippe Paquin  	Player 2 Win
Sabastian Chizhik  	vs.	Adam Tran  	Player 2 Win
Anthony LaCassa  	vs.	Pascal Weiler  	Player 2 Win
Dan Mui  	vs.	TCGTed Grabow  	Player 1 Win
Seth Penner  	vs.	Sam Sutherland  	Player 1 Win
Jodey Burney  	vs.	Justin Duszynski  	Player 1 Win
Kyle Meserve  	vs.	Luke Magnuson  	Player 2 Win
Tristan Kilper  	vs.	Adrian Malana  	Player 1 Win
Jakob Tummons  	vs.	Elijah Calub  	Player 2 Win
Shawn Adams  	vs.	James Chang  	Player 1 Win
Donovan Wilcox  	vs.	Natalie Hunt  	Player 2 Win
Viet Pham  	vs.	Pierre-Olivier Vallerand Beaudry  	Player 2 Win
Jeff Thompson  	vs.	Justin Hill  	Player 1 Win
June Aino  	vs.	Brandon Fields  	Player 2 Win
Rafaelo "Ruffy" Sarmiento  	vs.	Robert Postlewaite  	Player 1 Win
Mateusz Jasiński  	vs.	Jibek Azizkyzy  	Player 1 Win
Steven Nemeth  	vs.	Kristina (Kitty) Sick  	Player 1 Win
Zachary Sweigart  	vs.	Hollis Eacho  	Draw
James Curry  	vs.	Jerrica Stanko  	Player 1 Win
Lindsey Thiele  	vs.	Michael Huber  	Player 1 Win
Bryan Kong  	vs.	Trent Lennon  	Player 1 Win
Alexander Wolfe  	vs.	Jonathan Seaborn  	Player 1 Win
Artie Hamelin  	vs.	Thomas Coleman  	Player 2 Win
Gabriel Marengo  	vs.	Cameron Boutot  	Player 2 Win
Bun Ar  	vs.	Luis Jimenez  	Player 1 Win
Camilo Herrera  	vs.	Colin Ross  	Player 1 Win
David Hopson  	vs.	Donald Kell  	Player 1 Win
Chris Martin  	vs.	Dylon Brown  	Player 1 Win
James Gazawie  	vs.	Jacob Baugh  	Player 2 Win
Bryce Henschel  	vs.	Tyler Goodridge  	Player 1 Win
nicolas Jamoulle  	vs.	Nick Kiourkas  	Player 1 Win
Carter Barton  	vs.	None	Player 1 Win
Joshua Kehe  	vs.	Dexter Canright  	Player 1 Win
Sean Moyer  	vs.	Dennis Pham  	Player 1 Win
Mason Taylor  	vs.	Calvin Erven  	Player 1 Win
Adam Fronsee  	vs.	Eugene Schaefer  	Player 1 Win
Ricky Perez  	vs.	Jonny Espejo  	Player 2 Win
Fabio Rego  	vs.	Ryan AuCoin  	Player 1 Win
Mae French  	vs.	Joshua Lovell  	Player 2 Win
Ryker Taylor  	vs.	Adhy Kumar  	Player 2 Win
Kaiser Tan  	vs.	Nicholas Santa  	Player 2 Win
Ryan Wolohan  	vs.	Ricardo Rivera  	Player 1 Win
None	vs.	Max Small  	Player 2 Win
None	vs.	Kevin Brayer  	Player 2 Win
Ryan Wolfe  	vs.	Erin Lynn  	Double Loss
Abbas Dedanwala  	vs.	David Letourneau  	Player 2 Win
Leonardo Pessôa  	vs.	Nick Webb  	Player 1 Win
Andrew Mellina  	vs.	Levi Rauch  	Player 2 Win
Spencer Freeman  	vs.	None	Player 1 Win
Lexie Klasing  	vs.	Ryan Nenninger  	Player 1 Win
Edward Knight  	vs.	Thaminda Edirisooriya  	Draw
Holly Stowe  	vs.	William Nuckolls  	Double Loss
James Arthur  	vs.	Kyle Eckenrode  	Player 2 Win
Justin Cardoza  	vs.	Adam Green  	Player 2 Win
Tyler Kaminskie  	vs.	Paulo Fernandes  	Player 2 Win
Lee Conner  	vs.	Carson Osborne  	Player 2 Win
Caleb Nelson  	vs.	Albert Schütt  	Player 2 Win
John Farkas  	vs.	Zackary Whitt  	Player 2 Win
Sam (Real) Yuen  	vs.	Matthew Durci  	Player 2 Win
Josee Provencher  	vs.	Adam Matecki  	Player 1 Win
Garrett Shustarich  	vs.	Sam OByrne  	Player 2 Win
Michael Caronchia  	vs.	Nam Vo  	Player 2 Win
Brandon Gehron  	vs.	Jakub "Lemur" Siedlecki  	Player 2 Win
Chad Wischnewsky  	vs.	Tanner Propst  	Player 2 Win
Nicholas Hoover  	vs.	Ryan Levy  	Player 2 Win
Sara Smith  	vs.	Michael Pawlak  	Player 2 Win
Jasiel Diez  	vs.	Brandon Datwyler  	Player 1 Win
Greg Mitchell  	vs.	John Zapata  	Player 2 Win
Tommy Hendricks  	vs.	Hemal Patel  	Player 1 Win
Adam Weaver  	vs.	Jesse Boelens  	Player 1 Win
Andre Belote  	vs.	Kevin Lindenmayer  	Player 2 Win
Aaron Blum  	vs.	Dallas Weart  	Double Loss
Edward Kim  	vs.	John Powell  	Player 2 Win
Tae Kim  	vs.	Chris Sires  	Player 1 Win
Kyler Dustin  	vs.	Zdeněk Matura  	Player 2 Win
Johnny Lam  	vs.	Zoey Gerstner  	Player 1 Win
Devin Rattenni  	vs.	Lee Kimball  	Player 2 Win
Michael Dorsey  	vs.	Paul Naughton  	Player 2 Win
Elias Lucio  	vs.	Nick Allen  	Player 2 Win
George Ferris  	vs.	James Smith  	Player 1 Win
Justin Salmon  	vs.	Darryl Thompson  	Player 2 Win
None	vs.	Jeffrey Lang  	Player 2 Win
Justin Liwag  	vs.	Julian Sniffen  	Player 2 Win
Tanner DeMarco  	vs.	Robert Mills  	Player 2 Win
Elliot Bicker  	vs.	None	Player 1 Win
Sasha Lang  	vs.	None	Player 1 Win
David Mink  	vs.	Matthew DAntuono  	Player 1 Win
Joshua Freeland  	vs.	Sean Fox  	Player 1 Win
Matt Mills  	vs.	Tristan Hanson  	Player 2 Win
Derek Anderson  	vs.	Conner Holtgreive  	Player 1 Win
Logan Brushart  	vs.	Benjamin Hebert  	Player 2 Win
Menion Croll  	vs.	Todd Holman  	Player 1 Win
Sebastian Spicher  	vs.	Jordan McClure  	Player 1 Win
Andrew Nguyen  	vs.	Andrew MacNamee  	Player 1 Win
Devin Bell  	vs.	Nathanael Hunt  	Player 2 Win
Wyatt Goehring  	vs.	Keith Milde  	Player 2 Win
Dmitry Sorokin  	vs.	Jarred Singer  	Player 1 Win
Alex Ptak  	vs.	Thomas Coppage  	Player 1 Win
Michael DeBoard  	vs.	Jamie Utley  	Player 1 Win
Yuki Lee Bender  	vs.	Lorenzo Brambilla Pisoni  	Player 1 Win
Justin Rowland  	vs.	Andrew Shafer  	Player 1 Win
Dylan Vanpatten  	vs.	Dexter Phan  	Player 2 Win
JUSTIN FRYAR  	vs.	Jordan Biggs  	Player 1 Win
Rob Sheridan  	vs.	Nicholas Porter  	Player 2 Win
Jonathan Richards  	vs.	Hendrik Wytze Kluitenberg  	Player 1 Win
Ashley Yvette Bellevue  	vs.	Thomas Mottram  	Player 1 Win
Zach Dietz  	vs.	Anthony DT Zichella  	Player 1 Win
Nicholas Snyder  	vs.	Jacob Clements  	Player 2 Win
Howard Brody  	vs.	Elijah Flanders  	Player 2 Win
Andy Portillo  	vs.	connor rooney  	Player 2 Win
Zach Reinschreiber  	vs.	Bastien Le Guen  	Player 2 Win
Ryan Castilla  	vs.	Amber Pennington  	Player 2 Win
Kent Summerour  	vs.	Jason Watkins  	Player 1 Win
Adam Cook  	vs.	Jason Zhou  	Player 1 Win
Bryan Knecht  	vs.	None	Player 1 Win
Carter Bayne  	vs.	John Colvin  	Player 2 Win
Ashley Babiarz  	vs.	Parker Longwell  	Player 2 Win
Grant Kern  	vs.	Ryan Youngquist  	Player 1 Win
Lucas Barding  	vs.	Dyllon Dietz  	Player 2 Win
AJ Brown  	vs.	Rowsendo Nelson  	Player 1 Win
Mike DeNicola  	vs.	Luis Maderas  	Player 1 Win
Paul LE GOUEZ  	vs.	Jackie Rousseau  	Player 1 Win
Dakota Scales  	vs.	Jacob Balgoyen  	Draw
Jonathan Price  	vs.	Chad Bortz  	Player 2 Win
Donovan Mitchell  	vs.	Thorbjørn Lind Jensen  	Player 2 Win
Chad Emerick  	vs.	Colin Swisher  	Player 2 Win
Andrew Ali  	vs.	Jenna Schoettker  	Player 2 Win
Lucas Molho  	vs.	Jake Landaiche  	Player 1 Win
Nathaniel Meserve  	vs.	Chenjun Liu  	Player 2 Win
Dennis Mullins  	vs.	Martin Schelasin  	Player 2 Win
Ryan Fox  	vs.	Katie Koslosky  	Player 2 Win
None	vs.	Sean Davis  	Player 2 Win
Liam Trodden  	vs.	None	Player 1 Win
Robert Vruwink  	vs.	Samuel Ham  	Player 2 Win
Addison Hudson  	vs.	Jonathan Jackson  	Player 1 Win
Derek Copp  	vs.	Lee Maring  	Player 1 Win
ry mo  	vs.	Dan Groseclose  	Player 1 Win
Michael Fay  	vs.	William Pearlman  	Player 2 Win
Kevin Fontan  	vs.	Tyler Brotton  	Player 2 Win
Alexander Choiniere  	vs.	Matthew Steeves  	Player 2 Win
Blake Lococo  	vs.	Matthew Holinaty  	Player 2 Win
Aidan Kwasneski  	vs.	Gregory Patellis  	Player 2 Win
Alexander Hempelmann  	vs.	Logan Perry  	Player 2 Win
Noah Geiger  	vs.	Maciej Chmielewski  	Player 2 Win
Gary Kiebach  	vs.	Alex Brown  	Player 2 Win
Matthew Halstad  	vs.	Adam Roark  	Player 1 Win
Nicholas Murphy  	vs.	Josef Mendez  	Player 2 Win
Shaheen Soorani  	vs.	Christopher Lakkotrypis  	Player 1 Win
Kyle Richards  	vs.	Justin Sybrandt  	Player 1 Win
Corey Watson  	vs.	Alexander Karlson  	Player 2 Win
William Pate  	vs.	Skyler Cady  	Draw
Theodore Maximiuk  	vs.	Tessa Myers  	Player 1 Win
Heather Fechter  	vs.	AARON COLHOUER  	Player 2 Win
Jesus Garcia Gomez-Valades  	vs.	Franche Tan  	Player 2 Win
James Adams  	vs.	Zach Allen  	Player 1 Win
Matt Rogers  	vs.	Justin Harris  	Player 1 Win
Mark sipics  	vs.	Aaron Grace  	Player 2 Win
Dustin LaFlamme  	vs.	Desmond Lee  	Player 1 Win
Matthew Cudney  	vs.	Spencer Fritts  	Player 1 Win
Christopher Yunck  	vs.	Fuzzy Delp  	Player 1 Win
Eric Holmes  	vs.	Darren Black  	Player 2 Win
Merrick Kemp  	vs.	Bea Budnik  	Player 1 Win
Erik Johnson  	vs.	Kristopher Roache  	Player 1 Win
Catherine Powell  	vs.	Andrew Henderson  	Player 2 Win
JEREMY CHERNICK  	vs.	Thomas Dabney  	Player 1 Win
Daniel White  	vs.	Jeremy Scruggs  	Player 2 Win
Todd Rowe  	vs.	Tristan Mitchell  	Player 1 Win
James Swain  	vs.	Walker Stephens  	Player 1 Win
Kevin Set  	vs.	Jacob Bartram  	Player 1 Win
Eric Cortez omana  	vs.	Omar Bouras  	Player 1 Win
Adrian Gebhart  	vs.	Ciro Gambone  	Player 2 Win
David Sitrick  	vs.	Alexander Benton  	Player 2 Win
Jesse Shaw  	vs.	Dakota Cook  	Draw
Gerald Camangon  	vs.	DYLAN MANGINI  	Player 2 Win
Shane Martin  	vs.	Haukur Thor Buason  	Player 1 Win
Mark Tan  	vs.	Connor Bryant  	Player 2 Win
Michael Strianese  	vs.	Brock Weaver  	Player 1 Win
Mark Armitage  	vs.	Matt Muus  	Player 2 Win
Owen Young  	vs.	Alejandro Fernandez  	Player 1 Win
None	vs.	Tonin ''Nini'' Veshi  	Player 2 Win
Pierre-Nicolas Perrin  	vs.	Timothy Long  	Player 2 Win
Marco Jurakovich  	vs.	Aidan Arruza  	Player 1 Win
William Day  	vs.	Jake Woodward  	Player 2 Win
Wilson Lin  	vs.	Mohamed El Fardi  	Double Loss
Matthew Terrell  	vs.	None	Player 1 Win
Gordon Koh Koh  	vs.	steve clarke  	Player 1 Win
Jacob Milam  	vs.	Jordan Self  	Player 1 Win
Anthony Herzog  	vs.	Clay DeAngelis  	Player 2 Win
Everett Irby  	vs.	Matthew VanPatten  	Player 2 Win
Anthony Cicchinelli  	vs.	Taylor Crawford  	Player 2 Win
Daniel Bellotti  	vs.	Jacob Hudson  	Player 1 Win
Tanya Wunder  	vs.	John Wardan  	Player 2 Win
Davide Abis  	vs.	None	Player 1 Win
Josh Campos  	vs.	Travis Reeder  	Player 2 Win
Mateusz Sass  	vs.	Erick Boeder  	Player 1 Win
Yuanji Li  	vs.	Daniel Rutkowski  	Player 2 Win
Brian McLachlin  	vs.	Casey Walker  	Player 1 Win
Chris Kern  	vs.	Tyler Wolford  	Player 2 Win
Taylor Nifong  	vs.	Kevin Goodkin  	Player 1 Win
Nathan Gardner  	vs.	Chandler To  	Player 2 Win
Jason Price II  	vs.	Jonathan Wyatt  	Player 2 Win
Philip van Donselaar  	vs.	Reeve Chia  	Player 1 Win
Michael Lynch  	vs.	Erick Ortiz  	Player 1 Win
Mitchell Blowey  	vs.	Jacob Kissel  	Player 2 Win
William Bradshaw  	vs.	Jonas Stoberock  	Player 2 Win
Brandon Green  	vs.	Colton Miller  	Player 1 Win
Paul Mirande  	vs.	Yan Garito  	Player 2 Win
Thomas Briggs  	vs.	Nathan Borecki  	Player 1 Win
Joshua Korovesi  	vs.	Kyle Peterson  	Player 1 Win
Douglas Levy  	vs.	Ariana Loveday  	Player 1 Win
Leigh Pushard  	vs.	Bryan Kong  	Player 1 Win
Kolbrun Palsdottir  	vs.	Ian Smith  	Player 2 Win
Jonathen Byrd  	vs.	Jorge Gonzalez  	Player 1 Win
Andrew Wachter  	vs.	Nicholas Brown  	Player 1 Win
Alec Myers  	vs.	Jeff Okrasinski  	Player 1 Win
Robert Alonso  	vs.	Derek Byrne  	Player 1 Win
Jeffery Fredrickson  	vs.	Phillip Plew  	Player 1 Win
Eric Dauernnheim  	vs.	Mike Morelli  	Player 2 Win
Paul White  	vs.	James Tague  	Player 1 Win
Ben Sharrin  	vs.	Derek Chiu  	Player 2 Win
Andrew Bryant  	vs.	Brennan Tolnay  	Player 2 Win
The Better Johnson  	vs.	Piotr Krzempek  	Player 1 Win
None	vs.	Austin Kim  	Player 2 Win
Thomas Jaszczur  	vs.	Ben Cook  	Player 2 Win
Mitchel Tobey  	vs.	Scott Egan  	Player 2 Win
Gregory Price  	vs.	Jordan Brengartner  	Player 2 Win
Tyler Meacher  	vs.	RONNY MARTIN  	Player 1 Win
Rylie Groff  	vs.	Tony DeCaro  	Player 1 Win
Richard Whipkey  	vs.	Mitchell Tillery  	Player 2 Win
Haley Colson  	vs.	Dylan Ashcraft  	Player 2 Win
Austin Tippen  	vs.	Joseph Cicchini  	Player 1 Win
George Panageotou  	vs.	Kyle Hebert  	Player 2 Win
Paul Deegan  	vs.	Wilson Badillo  	Player 2 Win
Madison Theriault  	vs.	Matthew Fay  	Player 1 Win
Daniel Collett  	vs.	Nghia Tran  	Player 1 Win
Ilias Karamanis  	vs.	Dylan Williamson  	Player 2 Win
Mark Reisinger  	vs.	Cooper Templeton  	Player 2 Win
Travis McDaniel  	vs.	Jose Santos martinez  	Player 2 Win
None	vs.	Chase Reiser  	Player 2 Win
ryker taylor  	vs.	Dave Cordeiro  	Player 2 Win
Jonathan Magnuson  	vs.	Floris van Asch  	Player 1 Win
Nicholas Costanzo  	vs.	Daniel Smock  	Player 1 Win
BRAD ALLRED  	vs.	Michael Ribar  	Player 2 Win
Leo Shea  	vs.	Darius Hambleton  	Player 1 Win
Michael McDowell  	vs.	Kyle Gant  	Player 1 Win
Rodrigo Martinez  	vs.	Michael Tucci  	Player 1 Win
Peter Stanish  	vs.	Wesley Dong  	Player 1 Win
Shimon Bandiel  	vs.	Brandon Flores  	Player 1 Win
Aiden Dee  	vs.	Tuan Thai  	Player 1 Win
nicklas starland  	vs.	Ethan Kirychuk  	Player 1 Win
Tee Thebeau  	vs.	Nigel Wunder  	Player 1 Win
Anthony Laflamme  	vs.	Michael Lau  	Player 2 Win
Joseph Bartram  	vs.	Matthew Verderame  	Player 2 Win
David Brannen  	vs.	Tatiana Parada  	Player 1 Win
Nils Klaper  	vs.	Kenny Thai  	Player 1 Win
Patrick Nelson  	vs.	brynn nieboer  	Player 1 Win
Matt Smith  	vs.	Zachry Benz  	Player 2 Win
Andy truong  	vs.	Robbert Valkeneers  	Player 2 Win
Chris Legg  	vs.	Colin Walsh  	Player 1 Win
Yongji Yang  	vs.	Alexander Römisch  	Draw
Charles Simmons  	vs.	Chris Brummett  	Player 2 Win
Rogue Theory  	vs.	Taylor Irvin  	Double Loss
Chris Ray  	vs.	Nathaniel Snyder  	Player 2 Win
Frank Karamaroudis  	vs.	Amy Sherlock  	Player 1 Win
Jonathan Julian  	vs.	Alex Broussard  	Player 2 Win
Tomasz Buda  	vs.	Jonathan Walker  	Player 2 Win
Nicolas Bouffard  	vs.	Lucas Bannigan  	Player 2 Win
Clark Jansen  	vs.	Tom Evans  	Player 2 Win
John Romah  	vs.	Gwyndolin Newbill  	Player 1 Win
Dennis Zhang  	vs.	Alberto Ruiz  	Player 1 Win
Jason Irons  	vs.	Nathan Crawford  	Player 2 Win
Jeremy Langevin  	vs.	Drew Bosco  	Player 1 Win
Daniel Ferrara  	vs.	Lea Mari Gbur  	Player 1 Win
Jie ma  	vs.	Eric Shoopman  	Player 1 Win
Mathew Frye  	vs.	Michael McDermott  	Player 1 Win
Ravi Nehra  	vs.	Beren Mangubat  	Player 1 Win
David Trinh  	vs.	Joshua Jones  	Player 1 Win
Case Johnson  	vs.	Aidan O'Sullivan  	Player 2 Win
Amber Zee  	vs.	Jonah Overholt  	Player 1 Win
Paul Fortin  	vs.	David McEvoy  	Player 1 Win
Jordan Cook  	vs.	Ovas Siddiqui  	Player 2 Win
Connor Matza  	vs.	Jamie Grantham  	Player 2 Win
Claire Stanfield  	vs.	Joshua Rath  	Player 2 Win
Jesse Valdez  	vs.	Norman Bayliss  	Player 2 Win
Gary White  	vs.	Evan McGrew  	Player 1 Win
Kirk Dunlap  	vs.	Oliver Phi  	Player 2 Win
Andrew Melson  	vs.	Brandon Akers  	Player 2 Win
Porter Jones  	vs.	Emanuel Camacho  	Player 1 Win
Joseph Scalco  	vs.	Martin Hechtberger  	Player 2 Win
Randall Suliga  	vs.	Jack Stoney  	Player 2 Win
Jacob Johnson  	vs.	Jeremiah Gardner  	Player 2 Win
Emily Sipher  	vs.	Christopher Saldana  	Player 2 Win
Michael Bell  	vs.	Daniel Wolfe  	Player 1 Win
Sebastian Russell  	vs.	Paride Pirrotta  	Player 1 Win
Ashton Riggs  	vs.	Ektor Angelomatis  	Player 2 Win
Russell Hedlund  	vs.	ANDREW WEBBER  	Player 2 Win
Peyton Sayasith  	vs.	Derek Zellner  	Player 1 Win
Daniel Davila  	vs.	George Rodger  	Player 2 Win
Aliasgar Dedanwala  	vs.	Jason VanBuskirk  	Player 1 Win
ryan moran  	vs.	Brett Merold  	Player 1 Win
Chuck Hutchins  	vs.	Nicholas Mejac  	Player 1 Win
Tyler Kerch  	vs.	Guillem Las Heras Aixandri  	Player 1 Win
Phillip Manwaring  	vs.	Adam Duncan  	Player 1 Win
Alex Yun  	vs.	Bill Jargowsky  	Player 2 Win
Evan Zumwalt  	vs.	Terry Thai  	Player 1 Win
Haik Voskerchian  	vs.	Matt Jacobs  	Draw
Matthew Puckett  	vs.	Winter Fong  	Player 1 Win
Ryan Garris  	vs.	Chris Adcock  	Player 1 Win
Emery Powell  	vs.	James Cæruleus Silver  	Player 1 Win
Eric Gorski  	vs.	Christopher Higashi  	Player 2 Win
Tom Morris  	vs.	Chris Fazio  	Player 2 Win
Joshua Himmelberger  	vs.	Jacob Hawkinson  	Player 1 Win
Charles Poe  	vs.	Michael Feng  	Player 1 Win
Michael Toryk  	vs.	IAN PRIBIL  	Player 1 Win
Wesley Wilson  	vs.	Sebastian Linn  	Double Loss
Jacob Kurka  	vs.	Alek Idol  	Draw
Christopher Dietz  	vs.	Michael Zaun  	Player 1 Win
Chris Tellez  	vs.	Dave Lin  	Player 2 Win
Shing Tsang  	vs.	Brandan St. Amour  	Player 1 Win
jamie bithell  	vs.	Michael Popowich  	Player 1 Win
Joshua DeHaan  	vs.	Sean Yang  	Double Loss
Julian Felix Flury  	vs.	Jacob Dennis  	Player 1 Win
Tim Seib  	vs.	Andrew Peters  	Player 1 Win
Lucas Codato Antonio Silva  	vs.	Joseph Bowers  	Player 2 Win
Craig Pollack  	vs.	None	Player 1 Win
Travis Barton  	vs.	Alexandre Lefebvre  	Player 2 Win
Matt Davey  	vs.	Matthew Mosholder  	Player 1 Win
Erika Forslöf  	vs.	Jonathan (chugs) Moore  	Player 2 Win
Christian Ugaban  	vs.	Damien Riggins  	Player 2 Win
Airton dos Santos Junior  	vs.	Aria How  	Player 2 Win
Patrick Yoder  	vs.	Matt Borascius  	Player 1 Win
Bobby Jarboe  	vs.	Kyle Shull  	Player 1 Win
Cole Pellatt  	vs.	Caleb Womack  	Player 1 Win
Henry Robichaux  	vs.	Marvin Dominguez  	Player 2 Win
Blake Godenzi  	vs.	Ian Olson  	Player 2 Win
Micah Perino  	vs.	Keegan Wolohan  	Player 2 Win
Jake Griffin  	vs.	Ryan Thomas  	Player 2 Win
Steven Caraher  	vs.	Darren Rennie  	Player 1 Win
Will Pearce  	vs.	Logan Petersen  	Player 2 Win
Gabe Sher  	vs.	Evan Gassman  	Player 1 Win
Jacob Lantz  	vs.	Tony Le  	Player 1 Win
Philip Parker  	vs.	Bruno Cracco  	Player 1 Win
Manuel Rosario  	vs.	Chad Pennell  	Player 2 Win
Richard Anderson  	vs.	Mariusz Suchanecki  	Player 2 Win
Derek Reisinger  	vs.	William Euson  	Player 2 Win
Joshua Levy  	vs.	Vlastimil Martinek Jr.  	Player 2 Win
Kevin Canales  	vs.	None	Player 1 Win
Chad Allred  	vs.	Louis Solymos  	Player 2 Win
Kenneth Yan  	vs.	William Bodo  	Player 1 Win
Arkadiusz "Rasaad" Sioda  	vs.	Ethan Mitchell  	Player 1 Win
Fredrick Gamble  	vs.	Vincent Gambone  	Player 1 Win
Randall Sims  	vs.	Jordan Blankenship  	Player 1 Win
Branden Voss  	vs.	Jacob Neitling  	Player 1 Win
Quinn Wongkew  	vs.	Brandon Canedy  	Player 1 Win
Jonas Benz  	vs.	Daniel Edwards  	Player 1 Win
Alan Chavarin  	vs.	James Warburton  	Player 2 Win
Donovan van Beek  	vs.	Mike Euson  	Player 1 Win
Michael Rutkowski  	vs.	Kurt Coutu  	Player 1 Win
Julian Helgeson  	vs.	Dylan Myers  	Player 2 Win
William Berger  	vs.	Curtis Stapleton  	Double Loss
Trevor Charbonneau  	vs.	TUCKER CAMPBELL  	Player 2 Win
Lauren Morgan  	vs.	Joel Repta  	Player 2 Win
Brandon Bowden  	vs.	Mara Richard  	Player 1 Win
Matthew W  	vs.	Christian Gerdes  	Player 1 Win
Jesse Machusak  	vs.	Jesus Montijo  	Player 2 Win
Alex Slotnick  	vs.	Tommy Golightly  	Player 1 Win
Michael Townsend  	vs.	Rocky Cremeans  	Player 2 Win
Dustin Self  	vs.	Patrick Weiss  	Player 1 Win
Pete Stalker  	vs.	Peter Zsiga  	Draw
Sean Biava  	vs.	Nick Bova  	Player 2 Win
Andrew Goodwin  	vs.	Olivia Yauger  	Player 1 Win
Daniel Rothhaar  	vs.	Wesley Scott  	Player 1 Win
Cooper Pemelton  	vs.	BRENT ANDERSON  	Player 2 Win
Andrew Blackwell  	vs.	Joshua Paris  	Draw
Nicholas Trotta  	vs.	Spencer Beck  	Player 2 Win
Zach Bunn  	vs.	Carl Norman  	Player 1 Win
Anastasia Benner  	vs.	Zachary Campos  	Player 1 Win
Kyle Thiele  	vs.	Jeerod Balangan  	Player 2 Win
Ridgely Fahey  	vs.	Adam Jessell  	Player 2 Win
Michael Causey  	vs.	westley nottingham  	Player 2 Win
Bryce Johnson  	vs.	Tony Mapelli  	Player 2 Win
Niklas Bengtsson  	vs.	Kenneth Justin  	Player 2 Win
Michael Collins  	vs.	Travis Woodward  	Player 2 Win
Cory Lonas  	vs.	Stephen Perez  	Player 2 Win
Jared Wyce  	vs.	Jake Wenger  	Player 2 Win
Darick Oswalt  	vs.	Shane Blake  	Player 2 Win
Kevin Guinn  	vs.	Eli Teed  	Player 2 Win
Matt Garner  	vs.	Tuomas Kainulainen  	Player 1 Win
Elizabeth Sprinkle  	vs.	Matt MacLeod  	Player 2 Win
Ethan Bridges  	vs.	Andre Maldonado  	Player 2 Win
Raj Parikh  	vs.	Andrew Lundeen  	Player 1 Win
Tamara Reisinger  	vs.	Patrick Shaw  	Player 2 Win
Adam Columbia  	vs.	Samuel Hershey  	Player 2 Win
Ian Shaffer  	vs.	Timothy Scroggs  	Player 2 Win
Brandon Crawford  	vs.	Gabs Gable  	Player 2 Win
Terrence Blackwell  	vs.	Dustin Schutz  	Double Loss
Anthony Domalakes  	vs.	Will Reinhardt  	Player 2 Win
Douglas Maclure  	vs.	Philip Middleton  	Player 2 Win
Corey Waugh  	vs.	Fu Kah Deng  	Player 1 Win
Alex Milam  	vs.	Marcelo Gazzaneo  	Player 2 Win
Frédéric St-Laurent  	vs.	Ren Fisk  	Player 2 Win
Michael Riddle  	vs.	None	Player 1 Win
Aaron Guy  	vs.	Riley Lont  	Player 1 Win
Benjamin Williams  	vs.	Brandon Bianco  	Player 2 Win
Hank Sherlock  	vs.	Anderson Soares  	Player 2 Win
Justin Gottlieb  	vs.	anthony Petrillo  	Player 1 Win
joseph lawson  	vs.	Shawn Sapiel  	Player 1 Win
David Lee  	vs.	Christian Weißling  	Player 2 Win
Kyra Marks  	vs.	Kevin Tran  	Player 2 Win
Robin Avenoso  	vs.	Marcus Brown  	Draw
Skyler Lewis  	vs.	Caleb Zavits  	Player 1 Win
Aidan Berkel  	vs.	Caleb Broussard  	Player 2 Win
Adrian Słowiński  	vs.	James Thourgood  	Player 1 Win
Richard Smith  	vs.	Joshua Tavares  	Player 2 Win
Justin Addington  	vs.	Nick Tucker  	Player 2 Win
Holden Isaacs  	vs.	William Puckett  	Player 1 Win
Joel Grizzelle  	vs.	Kashiem Brown  	Player 1 Win
Justin Balanca-Hawkes  	vs.	Razer yan  	Player 1 Win
Will Rea  	vs.	Trenton McBride  	Player 2 Win
Connor Talty  	vs.	Daniel Warner  	Player 2 Win
Jasper Mork  	vs.	Joshua Lau  	Player 2 Win
Luke Shinn  	vs.	Erick Lofton  	Player 1 Win
Walter Snowden  	vs.	Thomas Engel  	Player 1 Win
nathan lapham  	vs.	Tom Philippi  	Player 2 Win
Johnathan Oliveira  	vs.	Melissa Steinman  	Player 2 Win
Jim Fullilove  	vs.	Cindrah Moore  	Player 2 Win
Felipe Costa Batista  	vs.	Corey Baker  	Player 2 Win
Ross Fontana  	vs.	None	Player 1 Win
David Reitenbach  	vs.	Anthony Cerenzio  	Player 2 Win
Dayna Hagewood  	vs.	Isaac Brooks  	Player 2 Win
Joshua Riddle  	vs.	Robert Teodorczy  	Player 2 Win
William OBrien  	vs.	Jesse Harper  	Player 2 Win
Allen Lau  	vs.	Benjamin Hannah  	Player 2 Win
Bartosz Dominiak  	vs.	Sage Husanu  	Player 2 Win
Max Dieckmann  	vs.	Tracy Reeves  	Player 1 Win
None	vs.	Hayley Neighbors  	Player 2 Win
James Prince  	vs.	Jason Brannick  	Player 2 Win
Anthony Chiechi  	vs.	Jeremy Seibert  	Player 1 Win
Jonathan Lemire  	vs.	Ian Daryl Bon  	Player 2 Win
Isaac Rancic  	vs.	Ryan Barnett  	Player 1 Win
Bradley Tashman  	vs.	Timothy Wells  	Player 1 Win
Daniel Correas  	vs.	None	Player 1 Win
#####
Carter Barton  	vs.	Michael Riddle  	Player 2 Win
Spencer Freeman  	vs.	Bryan Kong  	Player 2 Win
Elliot Bicker  	vs.	Tristan Hanson  	Player 2 Win
Sasha Lang  	vs.	Daniel Correas  	Player 2 Win
Bryan Knecht  	vs.	Anthony Chiechi  	Draw
Liam Trodden  	vs.	Matthew W  	Player 2 Win
Jeffrey Lang  	vs.	Cole Pellatt  	Player 2 Win
Matthew Terrell  	vs.	Oliver Phi  	Player 2 Win
Davide Abis  	vs.	Dave Lin  	Player 1 Win
Austin Kim  	vs.	Rafaelo "Ruffy" Sarmiento  	Player 1 Win
Tonin ''Nini'' Veshi  	vs.	Matt Garner  	Player 2 Win
Kevin Brayer  	vs.	Samuel Ham  	Player 1 Win
Kevin Canales  	vs.	Thomas Briggs  	Player 2 Win
Sean Davis  	vs.	Mason Taylor  	Player 1 Win
Ross Fontana  	vs.	Gabe Sher  	Player 2 Win
Hayley Neighbors  	vs.	Sean Moyer  	Player 2 Win
Chase Reiser  	vs.	Nam Vo  	Player 2 Win
Max Small  	vs.	Alex Ptak  	Player 2 Win
Tho Bui  	vs.	Paul White  	Player 2 Win
Mark Chamberlain  	vs.	Paul Naughton  	Player 2 Win
Anthony Gascon  	vs.	Corey Baker  	Player 2 Win
Gabriel Rasicot  	vs.	Seth Penner  	Player 2 Win
Jodey Burney  	vs.	Lindsey Thiele  	Player 1 Win
Roger Bodee  	vs.	Jordan Brengartner  	Player 1 Win
James Wray  	vs.	Logan Petersen  	Player 2 Win
Dan Mui  	vs.	Alex Brown  	Player 1 Win
Tristan Kilper  	vs.	Ektor Angelomatis  	Player 2 Win
Shawn Adams  	vs.	Anderson Soares  	Player 1 Win
Jeff Thompson  	vs.	Natalie Hunt  	Player 1 Win
Pierre-Olivier Vallerand Beaudry  	vs.	Bobby Jarboe  	Player 2 Win
Mateusz Jasiński  	vs.	nicklas starland  	Player 2 Win
Steven Nemeth  	vs.	Steven Rodriguez  	Player 2 Win
James Curry  	vs.	Kyle Hebert  	Player 2 Win
Alexander Wolfe  	vs.	Joseph Bowers  	Player 1 Win
Camilo Herrera  	vs.	Jonathan Wyatt  	Player 1 Win
Bun Ar  	vs.	Daniel Collett  	Player 1 Win
nicolas Jamoulle  	vs.	Alec Myers  	Player 1 Win
David Hopson  	vs.	Matthew Holinaty  	Player 2 Win
Chris Martin  	vs.	Christopher Higashi  	Player 1 Win
Bryce Henschel  	vs.	Derek Copp  	Player 2 Win
Adam Fronsee  	vs.	Andre Maldonado  	Player 2 Win
Joshua Kehe  	vs.	Jasiel Diez  	Player 1 Win
Fabio Rego  	vs.	Justin Balanca-Hawkes  	Player 1 Win
Leonardo Pessôa  	vs.	David Mink  	Player 1 Win
Lexie Klasing  	vs.	Adam Jessell  	Player 2 Win
Josee Provencher  	vs.	Parker Longwell  	Player 2 Win
Tommy Hendricks  	vs.	Jacob Baugh  	Player 2 Win
Adam Weaver  	vs.	Aaron Guy  	Player 2 Win
Tae Kim  	vs.	Matthew Halstad  	Player 2 Win
Johnny Lam  	vs.	Dave Cordeiro  	Player 2 Win
Matthew Durci  	vs.	Damien Riggins  	Player 2 Win
George Ferris  	vs.	Evan Zumwalt  	Player 2 Win
Brandon Fields  	vs.	Jonathan (chugs) Moore  	Player 2 Win
Joshua Freeland  	vs.	Jie ma  	Player 2 Win
Derek Anderson  	vs.	Philip Middleton  	Player 1 Win
Majin Bae  	vs.	Brandon Akers  	Player 2 Win
Menion Croll  	vs.	Philip Parker  	Player 2 Win
Sebastian Spicher  	vs.	Alex Slotnick  	Player 1 Win
Andrew Nguyen  	vs.	Theodore Maximiuk  	Player 1 Win
Dmitry Sorokin  	vs.	Nick Bova  	Player 1 Win
Michael DeBoard  	vs.	Nick Allen  	Player 2 Win
Yuki Lee Bender  	vs.	Philip van Donselaar  	Player 2 Win
Justin Rowland  	vs.	Scott Egan  	Player 1 Win
JUSTIN FRYAR  	vs.	Ryan Garris  	Player 2 Win
Lee Kimball  	vs.	Rocky Cremeans  	Player 1 Win
Jonathan Richards  	vs.	Zach Dietz  	Player 1 Win
Ashley Yvette Bellevue  	vs.	Addison Hudson  	Player 1 Win
Kent Summerour  	vs.	Chad Bortz  	Player 2 Win
Adam Cook  	vs.	Grant Kern  	Player 2 Win
Jonny Espejo  	vs.	Matthew VanPatten  	Player 2 Win
AJ Brown  	vs.	Daniel Rutkowski  	Player 2 Win
Mike DeNicola  	vs.	Samuel Hershey  	Player 2 Win
Paul LE GOUEZ  	vs.	Porter Jones  	Player 2 Win
Jakub "Lemur" Siedlecki  	vs.	Sebastian Russell  	Player 2 Win
Lucas Molho  	vs.	Caleb Broussard  	Player 1 Win
Martin Schelasin  	vs.	Christian Weißling  	Player 1 Win
ry mo  	vs.	David Brannen  	Player 1 Win
Kyle Richards  	vs.	Matt Rogers  	Player 1 Win
Shaheen Soorani  	vs.	Dennis Zhang  	Player 2 Win
James Adams  	vs.	Mateusz Sass  	Player 1 Win
Amber Pennington  	vs.	Wilson Badillo  	Player 2 Win
Dustin LaFlamme  	vs.	Michael Strianese  	Player 2 Win
Matthew Cudney  	vs.	Leigh Pushard  	Player 1 Win
Christopher Yunck  	vs.	Marvin Dominguez  	Player 2 Win
Merrick Kemp  	vs.	Jake Woodward  	Player 1 Win
Erik Johnson  	vs.	Joshua Himmelberger  	Player 2 Win
Todd Rowe  	vs.	Ciro Gambone  	Player 1 Win
JEREMY CHERNICK  	vs.	Gordon Koh Koh  	Player 2 Win
Kyle Eckenrode  	vs.	Brandon Green  	Player 1 Win
James Swain  	vs.	Taylor Nifong  	Player 1 Win
Kevin Set  	vs.	Thomas Hood  	Player 2 Win
Eric Cortez omana  	vs.	Matt Muus  	Player 1 Win
Shane Martin  	vs.	Alex Sneed  	Player 2 Win
Owen Young  	vs.	Maciej Chmielewski  	Player 2 Win
Dexter Phan  	vs.	Marcelo Gazzaneo  	Player 2 Win
Marco Jurakovich  	vs.	Mariusz Suchanecki  	Player 2 Win
Jacob Milam  	vs.	westley nottingham  	Player 1 Win
Daniel Wolff  	vs.	Brandon Bowden  	Player 1 Win
Cameron Boutot  	vs.	Tom Philippi  	Player 2 Win
Daniel Bellotti  	vs.	Benjamin Hebert  	Player 2 Win
Andrew Henderson  	vs.	Joshua Korovesi  	Player 1 Win
Brian McLachlin  	vs.	Isaac Brooks  	Player 1 Win
Adhy Kumar  	vs.	Brennan Tolnay  	Player 2 Win
Kevin Lindenmayer  	vs.	Mathew Frye  	Player 2 Win
Albert Schütt  	vs.	Zach Bunn  	Player 2 Win
Michael Lynch  	vs.	TUCKER CAMPBELL  	Player 1 Win
Zackary Whitt  	vs.	Joshua Tavares  	Player 2 Win
Jenna Schoettker  	vs.	Rylie Groff  	Draw
Douglas Levy  	vs.	joseph lawson  	Player 2 Win
Fernando Caprino  	vs.	Robert Mills  	Player 1 Win
Jonathen Byrd  	vs.	Nicholas Porter  	Player 2 Win
Andrew Wachter  	vs.	Darren Black  	Player 2 Win
Robert Alonso  	vs.	connor rooney  	Player 2 Win
Jeffery Fredrickson  	vs.	Patrick Nelson  	Player 2 Win
The Better Johnson  	vs.	Ian Smith  	Player 1 Win
Tyler Meacher  	vs.	Joshua Lovell  	Player 2 Win
Austin Tippen  	vs.	Bradley Tashman  	Player 2 Win
AARON COLHOUER  	vs.	Matt Davey  	Player 2 Win
Madison Theriault  	vs.	Joshua Rath  	Player 1 Win
Taylor Crawford  	vs.	Nathan Crawford  	Player 1 Win
Jonathan Magnuson  	vs.	Shane Blake  	Player 1 Win
Nicholas Costanzo  	vs.	Leo Shea  	Player 1 Win
Michael McDowell  	vs.	Frank Karamaroudis  	Player 2 Win
Rodrigo Martinez  	vs.	Julian Sniffen  	Player 2 Win
Peter Stanish  	vs.	Aaron Grace  	Player 2 Win
Shimon Bandiel  	vs.	Thomas Coleman  	Player 2 Win
Tee Thebeau  	vs.	Ryan Levy  	Player 1 Win
Alexander Benton  	vs.	Darryl Thompson  	Player 2 Win
Aiden Dee  	vs.	Steven Caraher  	Player 1 Win
Nils Klaper  	vs.	Ravi Nehra  	Player 1 Win
Chris Legg  	vs.	Zdeněk Matura  	Player 2 Win
Ben Cook  	vs.	Patrick Yoder  	Player 2 Win
John Romah  	vs.	Robert Teodorczy  	Player 1 Win
Jeremy Langevin  	vs.	Andrew Goodwin  	Player 1 Win
Daniel Ferrara  	vs.	Arkadiusz "Rasaad" Sioda  	Player 1 Win
Carson Osborne  	vs.	Adrian Słowiński  	Draw
Michael Lau  	vs.	Gary White  	Player 1 Win
David Trinh  	vs.	Dustin Self  	Player 1 Win
Amber Zee  	vs.	Joel Repta  	Player 2 Win
Paul Fortin  	vs.	William Pearlman  	Player 2 Win
Philippe Paquin  	vs.	Tyler Brotton  	Player 2 Win
Chenjun Liu  	vs.	Peyton Sayasith  	Player 2 Win
Michael Bell  	vs.	Dylan Ashcraft  	Player 2 Win
Aliasgar Dedanwala  	vs.	Chris Fazio  	Player 2 Win
Chandler To  	vs.	Aidan O'Sullivan  	Player 2 Win
ryan moran  	vs.	Elijah Flanders  	Player 1 Win
Tanner Propst  	vs.	Paulo Fernandes  	Player 1 Win
Christopher Saldana  	vs.	Sam OByrne  	Player 2 Win
Nathaniel Snyder  	vs.	Phillip Manwaring  	Player 2 Win
Tyler Kerch  	vs.	Shing Tsang  	Player 1 Win
Chuck Hutchins  	vs.	Michael Ribar  	Player 1 Win
Matthew Puckett  	vs.	Kenneth Justin  	Player 2 Win
Emery Powell  	vs.	Jeremy Scruggs  	Player 1 Win
Charles Poe  	vs.	Michael Toryk  	Player 2 Win
Christopher Dietz  	vs.	Donovan van Beek  	Player 2 Win
Matthew Steeves  	vs.	Alex Broussard  	Player 2 Win
jamie bithell  	vs.	Tim Seib  	Player 1 Win
Julian Felix Flury  	vs.	Jamie Grantham  	Player 1 Win
Logan Perry  	vs.	Colin Swisher  	Player 2 Win
ANDREW WEBBER  	vs.	Zack Phillips  	Player 2 Win
Levi Rauch  	vs.	Kenneth Yan  	Player 1 Win
Lucas Bannigan  	vs.	Chad Pennell  	Player 1 Win
Keith Milde  	vs.	Jesse Harper  	Player 2 Win
Yan Garito  	vs.	Stephen Perez  	Player 1 Win
Michael Pawlak  	vs.	Mitchell Tillery  	Player 2 Win
Clay DeAngelis  	vs.	Aria How  	Player 1 Win
Fredrick Gamble  	vs.	Justin Gottlieb  	Player 2 Win
Randall Sims  	vs.	Quinn Wongkew  	Player 1 Win
Branden Voss  	vs.	Corey Waugh  	Player 2 Win
Tyler Wolford  	vs.	John Colvin  	Player 2 Win
Jonas Benz  	vs.	Spencer Beck  	Player 2 Win
Elijah Calub  	vs.	Luke Shinn  	Player 1 Win
Jonathan Walker  	vs.	Dylan Myers  	Player 2 Win
Michael Rutkowski  	vs.	Sage Husanu  	Player 2 Win
DYLAN MANGINI  	vs.	Mike Morelli  	Player 1 Win
Pascal Weiler  	vs.	Alexander Karlson  	Player 1 Win
Cooper Templeton  	vs.	Melissa Steinman  	Player 1 Win
Alex Tyler  	vs.	Jacob Clements  	Player 1 Win
Keegan Wolohan  	vs.	Jose Santos martinez  	Player 2 Win
Daniel Rothhaar  	vs.	Matt MacLeod  	Player 2 Win
Franche Tan  	vs.	David Letourneau  	Player 1 Win
Anastasia Benner  	vs.	Ryan Thomas  	Player 2 Win
James Warburton  	vs.	Kevin Tran  	Player 2 Win
Jesus Montijo  	vs.	Ian Olson  	Player 2 Win
Jonas Stoberock  	vs.	Max Dieckmann  	Player 2 Win
Adam Tran  	vs.	Nick Tucker  	Player 2 Win
Dyllon Dietz  	vs.	Isaac Rancic  	Player 1 Win
George Rodger  	vs.	Will Reinhardt  	Player 1 Win
BRENT ANDERSON  	vs.	Anthony Cerenzio  	Player 2 Win
Raj Parikh  	vs.	Robbert Valkeneers  	Player 1 Win
Alexandre Lefebvre  	vs.	Bastien Le Guen  	Player 2 Win
Timothy Long  	vs.	Ryan Goldfinger  	Player 1 Win
Nicholas Santa  	vs.	Jacob Lantz  	Player 2 Win
Nathanael Hunt  	vs.	John Zapata  	Player 1 Win
Norman Bayliss  	vs.	Ian Daryl Bon  	Player 2 Win
Matthew Verderame  	vs.	Ren Fisk  	Player 2 Win
Jake Wenger  	vs.	Gabs Gable  	Player 1 Win
Skyler Lewis  	vs.	Travis Woodward  	Player 1 Win
Jeerod Balangan  	vs.	Trenton McBride  	Player 2 Win
Holden Isaacs  	vs.	Joel Grizzelle  	Player 2 Win
Timothy Scroggs  	vs.	John Powell  	Player 1 Win
Luke Magnuson  	vs.	Derek Chiu  	Player 1 Win
Martin Hechtberger  	vs.	Zachry Benz  	Player 2 Win
Walter Snowden  	vs.	Louis Solymos  	Player 2 Win
Joshua Lau  	vs.	Jason Brannick  	Player 1 Win
William Euson  	vs.	Patrick Shaw  	Player 2 Win
Gregory Patellis  	vs.	Katie Koslosky  	Player 1 Win
Connor Bryant  	vs.	Bill Jargowsky  	Player 1 Win
Jacob Kissel  	vs.	Tony Mapelli  	Player 1 Win
Adam Green  	vs.	John Wardan  	Player 2 Win
Ovas Siddiqui  	vs.	Daniel Warner  	Player 1 Win
Dylan Williamson  	vs.	Tom Evans  	Player 1 Win
Cindrah Moore  	vs.	Jack Stoney  	Player 2 Win
Thorbjørn Lind Jensen  	vs.	Jeremiah Gardner  	Player 2 Win
Benjamin Hannah  	vs.	Vlastimil Martinek Jr.  	Player 2 Win
Josef Mendez  	vs.	Eli Teed  	Player 2 Win
Travis Reeder  	vs.	Brandon Bianco  	Player 2 Win
VINAY SONI  	vs.	Derek Byrne  	Player 1 Win
Zachary Sweigart  	vs.	Tyler Kaminskie  	Player 2 Win
Ben Hannan  	vs.	Connor Talty  	Player 1 Win
Rob Catton  	vs.	Olivia Yauger  	Player 2 Win
Edward Knight  	vs.	Will Rea  	Player 1 Win
Matthew Boudreaux  	vs.	Andrew Bryant  	Player 2 Win
Skyler Cady  	vs.	Rowsendo Nelson  	Player 2 Win
Long Dao  	vs.	Michael Dorsey  	Player 2 Win
Dakota Scales  	vs.	Jamie Utley  	Player 2 Win
None	vs.	Ian Shaffer  	Player 2 Win
William Pate  	vs.	Nick Webb  	Draw
Justin Matlack  	vs.	Chris Adcock  	Player 1 Win
Jesse Shaw  	vs.	Jesus Garcia Gomez-Valades  	Player 2 Win
Quinn Toulouse  	vs.	Eric Gorski  	Player 2 Win
Nova Chan  	vs.	Ricky Perez  	Player 2 Win
Ben Mapes  	vs.	Adrian Malana  	Player 2 Win
Jacob Balgoyen  	vs.	Sara Smith  	Player 1 Win
Matthew Philliips  	vs.	Brandon Canedy  	Player 2 Win
Thaminda Edirisooriya  	vs.	Matt Mills  	Player 1 Win
Jon Smith  	vs.	Alex Yun  	Player 2 Win
Ryan Rich  	vs.	George Panageotou  	Player 2 Win
Jamie Doan  	vs.	Connor Matza  	Player 2 Win
Brian Ordona  	vs.	Daniel Smock  	Player 2 Win
Thomas Preyer  	vs.	Cory Lonas  	Player 2 Win
Haik Voskerchian  	vs.	Ethan Mitchell  	Player 1 Win
Jacob Kurka  	vs.	David Lee  	Player 2 Win
Dakota Cook  	vs.	Anthony Cicchinelli  	Player 2 Win
Joe DeCaussin  	vs.	Dayna Hagewood  	Player 2 Win
Hollis Eacho  	vs.	Kashiem Brown  	Player 1 Win
Leila Green  	vs.	Christian Ugaban  	Player 2 Win
Jordan Leggett  	vs.	Pierre-Nicolas Perrin  	Player 2 Win
Pete Stalker  	vs.	Sam Sutherland  	Player 2 Win
Andrew Blackwell  	vs.	Daniel Davila  	Player 1 Win
Thomas Walsh  	vs.	Jackie Rousseau  	Player 2 Win
Joe Colon  	vs.	Justin Liwag  	Player 2 Win
Nicholai DeHaan  	vs.	Chad Allred  	Player 2 Win
Matt Jacobs  	vs.	Brandon Flores  	Player 2 Win
Alissa Clarke  	vs.	Timothy Wells  	Player 2 Win
Robin Avenoso  	vs.	Bartosz Dominiak  	Player 1 Win
Benjamin Smith  	vs.	Jonah Overholt  	Player 2 Win
Chloe Thio  	vs.	Kyle Gant  	Player 2 Win
Matthew Duggan  	vs.	Robert Postlewaite  	Player 2 Win
Simon Black  	vs.	Eric Holmes  	Player 2 Win
Peter Zsiga  	vs.	Colton Miller  	Draw
Tim Sofsky  	vs.	Michael Fay  	Player 2 Win
Eduardo Melo  	vs.	James Thourgood  	Player 2 Win
Alek Idol  	vs.	Mark Tan  	Player 2 Win
Joshua Paris  	vs.	Andrew MacNamee  	Player 1 Win
Marcus Brown  	vs.	brynn nieboer  	Player 1 Win
Maximilian Klein  	vs.	Brandan St. Amour  	Player 2 Win
Jake Warburton  	vs.	Andre Belote  	Player 2 Win
Phillip Bradford  	vs.	Anthony Herzog  	Player 2 Win
Michael Cusick  	vs.	Aidan Arruza  	Player 2 Win
Daniel Link  	vs.	Ryan Fox  	Draw
Chad McKittrick  	vs.	Nicolas Bouffard  	Player 1 Win
Brandon Salvatore  	vs.	Russell Hedlund  	Player 1 Win
Chris Rowland  	vs.	Fuzzy Delp  	Player 2 Win
Allison Oram  	vs.	Tyler Goodridge  	Draw
Sabastian Chizhik  	vs.	Tatiana Parada  	Player 1 Win
Kyle Meserve  	vs.	Mae French  	Player 2 Win
Lorenzo Brambilla Pisoni  	vs.	James Smith  	Player 1 Win
Viet Pham  	vs.	Greg Mitchell  	Player 1 Win
Donovan Wilcox  	vs.	Kyle Shull  	Player 2 Win
June Aino  	vs.	Guillem Las Heras Aixandri  	Draw
Artie Hamelin  	vs.	Ben Sharrin  	Player 2 Win
Gabriel Marengo  	vs.	Jordan Biggs  	Player 2 Win
Kaiser Tan  	vs.	Justin Hill  	Player 2 Win
Abbas Dedanwala  	vs.	Alberto Ruiz  	Player 2 Win
Andrew Mellina  	vs.	Justin Duszynski  	Player 2 Win
Justin Cardoza  	vs.	Noah Geiger  	Player 1 Win
Lee Conner  	vs.	Douglas Maclure  	Player 1 Win
Caleb Nelson  	vs.	Mike Euson  	Player 2 Win
Sam (Real) Yuen  	vs.	Brett Merold  	Player 2 Win
Garrett Shustarich  	vs.	Micah Perino  	Player 2 Win
Brandon Gehron  	vs.	Darren Rennie  	Player 2 Win
Chad Wischnewsky  	vs.	Zach Reinschreiber  	Player 1 Win
Nicholas Hoover  	vs.	BRAD ALLRED  	Player 2 Win
Kyler Dustin  	vs.	Joseph Cicchini  	Player 1 Win
Devin Rattenni  	vs.	Ryan AuCoin  	Player 2 Win
Justin Salmon  	vs.	Darick Oswalt  	Player 1 Win
Tanner DeMarco  	vs.	Will Pearce  	Player 2 Win
Logan Brushart  	vs.	Ethan Bridges  	Player 1 Win
Rene Nottingham  	vs.	Charles Simmons  	Player 2 Win
Devin Bell  	vs.	Ridgely Fahey  	Player 1 Win
Wyatt Goehring  	vs.	Jonathan Price  	Player 1 Win
Bryce Kesterson  	vs.	Shawn Sapiel  	Player 1 Win
Dylan Vanpatten  	vs.	Tony DeCaro  	Player 2 Win
Rob Sheridan  	vs.	Andy Portillo  	Player 1 Win
Nicholas Snyder  	vs.	Michael Tucci  	Player 1 Win
Ryan Castilla  	vs.	Andrew Ali  	Player 2 Win
Carter Bayne  	vs.	William Bodo  	Player 2 Win
Ryan Nenninger  	vs.	Jeremy Seibert  	Player 1 Win
Ashley Babiarz  	vs.	Felipe Costa Batista  	Player 2 Win
Donovan Mitchell  	vs.	Nicholas Brown  	Player 1 Win
Chad Emerick  	vs.	Zoey Gerstner  	Player 1 Win
Nathaniel Meserve  	vs.	Jason VanBuskirk  	Player 1 Win
Dennis Mullins  	vs.	Justin Addington  	Player 2 Win
Robert Vruwink  	vs.	Chris Ray  	Player 2 Win
Kevin Fontan  	vs.	Michael Causey  	Player 1 Win
Alexander Choiniere  	vs.	Claire Stanfield  	Player 2 Win
Blake Lococo  	vs.	Nicholas Murphy  	Player 1 Win
Aidan Kwasneski  	vs.	Gwyndolin Newbill  	Player 1 Win
Alexander Hempelmann  	vs.	Everett Irby  	Player 1 Win
Gary Kiebach  	vs.	Ryan Barnett  	Player 2 Win
Donald Kell  	vs.	Tomasz Buda  	Player 1 Win
Adam Roark  	vs.	Andrew Lundeen  	Draw
Corey Watson  	vs.	Vincent Gambone  	Player 2 Win
Heather Fechter  	vs.	Adrian Gebhart  	Player 2 Win
Mark sipics  	vs.	Dexter Canright  	Player 2 Win
Catherine Powell  	vs.	Ryan Wolohan  	Player 2 Win
David Sitrick  	vs.	Nicholas Trotta  	Player 2 Win
Gerald Camangon  	vs.	Jacob Hawkinson  	Player 2 Win
Jordan Self  	vs.	Jonathan Seaborn  	Player 1 Win
Tanya Wunder  	vs.	Kristina (Kitty) Sick  	Player 1 Win
Bea Budnik  	vs.	Joshua Riddle  	Player 1 Win
Josh Campos  	vs.	William Bradshaw  	Player 2 Win
Yuanji Li  	vs.	Chris Kern  	Player 1 Win
Nathan Gardner  	vs.	Case Johnson  	Player 1 Win
Jason Price II  	vs.	anthony Petrillo  	Player 2 Win
Mitchell Blowey  	vs.	Tessa Myers  	Player 1 Win
Christopher Lakkotrypis  	vs.	Devon Conn  	Player 2 Win
Kolbrun Palsdottir  	vs.	Kenny Thai  	Player 1 Win
Brandon Datwyler  	vs.	Dennis Pham  	Player 1 Win
Hendrik Wytze Kluitenberg  	vs.	Erick Boeder  	Player 1 Win
Eric Dauernnheim  	vs.	Zach Allen  	Player 2 Win
Thomas Jaszczur  	vs.	Luis Maderas  	Player 1 Win
Mitchel Tobey  	vs.	Julian Helgeson  	Player 1 Win
Gregory Price  	vs.	Joseph Scalco  	Player 2 Win
Erick Ortiz  	vs.	Conner Holtgreive  	Player 1 Win
Richard Whipkey  	vs.	Jasper Mork  	Player 2 Win
Paul Deegan  	vs.	Ethan Kirychuk  	Player 1 Win
Justin Sybrandt  	vs.	Ashton Riggs  	Player 1 Win
Anthony Laflamme  	vs.	Andrew Shafer  	Player 1 Win
Piotr Krzempek  	vs.	Colin Ross  	Player 1 Win
Matt Smith  	vs.	Zachary Campos  	Player 1 Win
Andy truong  	vs.	Carl Norman  	Player 2 Win
Jonathan Julian  	vs.	Justin Harris  	Player 1 Win
Jason Irons  	vs.	Manuel Rosario  	Player 1 Win
Jeff Okrasinski  	vs.	Darius Hambleton  	Player 1 Win
Andrew Melson  	vs.	Kevin Goodkin  	Player 1 Win
Desmond Lee  	vs.	Thomas Mottram  	Player 2 Win
Randall Suliga  	vs.	James Tague  	Player 1 Win
Lee Maring  	vs.	James Prince  	Player 1 Win
Jesse Boelens  	vs.	Daniel Wolfe  	Player 2 Win
Jacob Hudson  	vs.	Sean Fox  	Player 2 Win
Evan McGrew  	vs.	Jesse Machusak  	Player 2 Win
Walker Stephens  	vs.	Trent Lennon  	Player 2 Win
Eric LaGaccia  	vs.	Eric Shoopman  	Player 2 Win
Lucas Barding  	vs.	Blake Godenzi  	Player 2 Win
Anthony DT Zichella  	vs.	Joshua Levy  	Player 1 Win
Lucas Codato Antonio Silva  	vs.	Jake Landaiche  	Player 2 Win
Erika Forslöf  	vs.	Spencer Fritts  	Player 1 Win
RONNY MARTIN  	vs.	Dylon Brown  	Player 1 Win
Airton dos Santos Junior  	vs.	Michael Collins  	Player 2 Win
Henry Robichaux  	vs.	Caleb Zavits  	Player 2 Win
Jake Griffin  	vs.	Haukur Thor Buason  	Player 2 Win
Bruno Cracco  	vs.	Floris van Asch  	Player 1 Win
Jacob Dennis  	vs.	David Reitenbach  	Player 2 Win
Alan Chavarin  	vs.	Aidan Berkel  	Player 2 Win
Jorge Gonzalez  	vs.	Emanuel Camacho  	Player 2 Win
Eugene Schaefer  	vs.	Erick Lofton  	Player 2 Win
Tommy Golightly  	vs.	Michael Popowich  	Player 1 Win
Cooper Pemelton  	vs.	Sean Biava  	Player 2 Win
Kyle Thiele  	vs.	Michael McDermott  	Draw
Bryce Johnson  	vs.	Tracy Reeves  	Player 1 Win
Jared Wyce  	vs.	Riley Lont  	Player 2 Win
Kevin Guinn  	vs.	Mara Richard  	Player 1 Win
Daniel Edwards  	vs.	Christian Gerdes  	Player 2 Win
Brandon Crawford  	vs.	Jonathan Lemire  	Player 2 Win
Anthony Domalakes  	vs.	James Cæruleus Silver  	Player 2 Win
Alex Milam  	vs.	None	Player 1 Win
Kyle Peterson  	vs.	Nicholas Mejac  	Player 2 Win
Nigel Wunder  	vs.	Derek Zellner  	Player 1 Win
Tuomas Kainulainen  	vs.	Matthew Fay  	Player 2 Win
Kristopher Roache  	vs.	Caleb Womack  	Player 2 Win
Tristan Mitchell  	vs.	Jordan Blankenship  	Player 1 Win
Chris Brummett  	vs.	None	Player 1 Win
#####
Davide Abis  	vs.	Ashley Yvette Bellevue  	Player 1 Win
Austin Kim  	vs.	Parker Longwell  	Player 1 Win
Kevin Brayer  	vs.	Daniel Correas  	Player 2 Win
Sean Davis  	vs.	William Pearlman  	Player 2 Win
Seth Penner  	vs.	ry mo  	Player 1 Win
Jodey Burney  	vs.	David Trinh  	Player 2 Win
Jeff Thompson  	vs.	Thomas Briggs  	Player 1 Win
Joshua Kehe  	vs.	Kyle Hebert  	Player 1 Win
Fabio Rego  	vs.	Nicholas Porter  	Player 2 Win
Jonathan Richards  	vs.	Todd Rowe  	Player 1 Win
Lucas Molho  	vs.	Joshua Lau  	Player 1 Win
Derek Copp  	vs.	Aaron Guy  	Player 1 Win
Kyle Richards  	vs.	DYLAN MANGINI  	Player 2 Win
James Adams  	vs.	Jacob Milam  	Player 1 Win
Merrick Kemp  	vs.	Leonardo Pessôa  	Player 1 Win
Daniel Wolff  	vs.	Brian McLachlin  	Player 1 Win
Michael Lynch  	vs.	Jonathan (chugs) Moore  	Player 2 Win
Fernando Caprino  	vs.	Dylan Williamson  	Player 2 Win
The Better Johnson  	vs.	Philip Parker  	Player 2 Win
Madison Theriault  	vs.	Tee Thebeau  	Player 2 Win
Taylor Crawford  	vs.	Alex Tyler  	Player 1 Win
Nicholas Costanzo  	vs.	Randall Sims  	Player 2 Win
Dennis Zhang  	vs.	Jie ma  	Player 2 Win
Brennan Tolnay  	vs.	Benjamin Hebert  	Player 1 Win
Michael Lau  	vs.	Justin Rowland  	Player 1 Win
Porter Jones  	vs.	Patrick Yoder  	Player 2 Win
Zdeněk Matura  	vs.	Chris Brummett  	Player 1 Win
Tyler Brotton  	vs.	Nick Tucker  	Player 1 Win
ryan moran  	vs.	Joshua Lovell  	Player 2 Win
Tanner Propst  	vs.	Joshua Himmelberger  	Player 1 Win
Chuck Hutchins  	vs.	Skyler Lewis  	Player 1 Win
Emery Powell  	vs.	George Rodger  	Player 1 Win
Julian Sniffen  	vs.	Zach Bunn  	Player 2 Win
Alex Broussard  	vs.	Yan Garito  	Player 2 Win
Bobby Jarboe  	vs.	Dylan Myers  	Player 2 Win
Daniel Rutkowski  	vs.	Kenneth Justin  	Player 1 Win
Clay DeAngelis  	vs.	Ryan Thomas  	Player 1 Win
Brandon Akers  	vs.	Damien Riggins  	Player 2 Win
Donovan van Beek  	vs.	Kevin Tran  	Player 1 Win
Darren Black  	vs.	Jacob Kissel  	Player 2 Win
Colin Swisher  	vs.	Camilo Herrera  	Player 1 Win
Franche Tan  	vs.	Paul White  	Player 2 Win
Wilson Badillo  	vs.	Michael Toryk  	Player 2 Win
Logan Petersen  	vs.	Levi Rauch  	Player 2 Win
Ian Olson  	vs.	Timothy Long  	Player 2 Win
Nathanael Hunt  	vs.	Justin Gottlieb  	Player 1 Win
Zachry Benz  	vs.	Eli Teed  	Player 2 Win
Matthew Holinaty  	vs.	Sebastian Russell  	Draw
Spencer Beck  	vs.	Eric Cortez omana  	Player 2 Win
Gregory Patellis  	vs.	Darryl Thompson  	Player 2 Win
Louis Solymos  	vs.	Gabe Sher  	Player 1 Win
Connor Bryant  	vs.	Gordon Koh Koh  	Player 1 Win
Ian Daryl Bon  	vs.	John Wardan  	Player 1 Win
Bradley Tashman  	vs.	Philip van Donselaar  	Player 2 Win
Corey Baker  	vs.	Andrew Nguyen  	Player 2 Win
Jack Stoney  	vs.	Ektor Angelomatis  	Player 1 Win
Anthony Cerenzio  	vs.	Pascal Weiler  	Player 1 Win
Paul Naughton  	vs.	Mathew Frye  	Player 1 Win
Matthew Halstad  	vs.	Ren Fisk  	Player 2 Win
Tyler Kerch  	vs.	Chris Martin  	Player 2 Win
Raj Parikh  	vs.	joseph lawson  	Player 1 Win
Zack Phillips  	vs.	Jonathan Magnuson  	Player 2 Win
Bryan Kong  	vs.	Sebastian Spicher  	Player 1 Win
Cole Pellatt  	vs.	Dan Mui  	Player 2 Win
Matthew W  	vs.	Tristan Hanson  	Player 1 Win
Timothy Scroggs  	vs.	Matthew Cudney  	Player 1 Win
Marcelo Gazzaneo  	vs.	Sean Moyer  	Player 1 Win
Roger Bodee  	vs.	Vlastimil Martinek Jr.  	Player 1 Win
Shawn Adams  	vs.	Corey Waugh  	Player 1 Win
Alexander Wolfe  	vs.	John Colvin  	Player 2 Win
Bun Ar  	vs.	Dmitry Sorokin  	Player 1 Win
nicolas Jamoulle  	vs.	Jose Santos martinez  	Player 1 Win
Derek Anderson  	vs.	Oliver Phi  	Player 2 Win
Lee Kimball  	vs.	Grant Kern  	Player 1 Win
Martin Schelasin  	vs.	Kyle Eckenrode  	Player 2 Win
Nick Allen  	vs.	Matt MacLeod  	Player 2 Win
Chad Bortz  	vs.	Ryan Garris  	Player 2 Win
James Swain  	vs.	Matthew VanPatten  	Player 2 Win
Michael Strianese  	vs.	Elijah Calub  	Player 2 Win
Andrew Henderson  	vs.	Dyllon Dietz  	Player 1 Win
Maciej Chmielewski  	vs.	Alex Sneed  	Player 1 Win
connor rooney  	vs.	Phillip Manwaring  	Player 1 Win
Thomas Hood  	vs.	Sage Husanu  	Player 1 Win
nicklas starland  	vs.	Peyton Sayasith  	Player 2 Win
Aiden Dee  	vs.	Jeremy Langevin  	Player 2 Win
Nils Klaper  	vs.	Max Dieckmann  	Player 2 Win
Patrick Nelson  	vs.	Daniel Ferrara  	Player 2 Win
John Romah  	vs.	Patrick Shaw  	Player 2 Win
Thomas Coleman  	vs.	Evan Zumwalt  	Player 1 Win
jamie bithell  	vs.	Marvin Dominguez  	Player 2 Win
Julian Felix Flury  	vs.	Jacob Lantz  	Player 2 Win
Matt Davey  	vs.	Lucas Bannigan  	Player 2 Win
Aidan O'Sullivan  	vs.	Joel Grizzelle  	Player 2 Win
Steven Rodriguez  	vs.	Chris Fazio  	Player 2 Win
Cooper Templeton  	vs.	Alex Ptak  	Player 2 Win
Sam OByrne  	vs.	Adam Jessell  	Player 1 Win
Mitchell Tillery  	vs.	Jake Wenger  	Player 2 Win
Dylan Ashcraft  	vs.	Michael Riddle  	Player 1 Win
Dave Cordeiro  	vs.	Luke Magnuson  	Player 1 Win
Joshua Tavares  	vs.	Samuel Hershey  	Player 2 Win
Tom Philippi  	vs.	Mariusz Suchanecki  	Player 2 Win
Aaron Grace  	vs.	Joel Repta  	Player 2 Win
Jacob Baugh  	vs.	Andre Maldonado  	Player 1 Win
Bastien Le Guen  	vs.	Trenton McBride  	Player 2 Win
Ovas Siddiqui  	vs.	Jesse Harper  	Player 2 Win
Jeremiah Gardner  	vs.	Brandon Bianco  	Player 1 Win
Nam Vo  	vs.	Matt Garner  	Player 2 Win
Ryan Wolohan  	vs.	Albert Schütt  	Player 2 Win
Bryan Knecht  	vs.	Matthew Steeves  	Player 2 Win
Jenna Schoettker  	vs.	Haukur Thor Buason  	Player 2 Win
Rylie Groff  	vs.	Keegan Wolohan  	Player 1 Win
Carson Osborne  	vs.	Jacob Balgoyen  	Player 2 Win
Adrian Słowiński  	vs.	Aidan Kwasneski  	Player 1 Win
Anthony Chiechi  	vs.	Daniel Collett  	Player 1 Win
Anthony Gascon  	vs.	David Letourneau  	Player 2 Win
James Wray  	vs.	Alexander Karlson  	Player 1 Win
Tristan Kilper  	vs.	Isaac Rancic  	Player 2 Win
Pierre-Olivier Vallerand Beaudry  	vs.	Trent Lennon  	Player 2 Win
Rafaelo "Ruffy" Sarmiento  	vs.	Tyler Kaminskie  	Player 1 Win
David Hopson  	vs.	Luke Shinn  	Player 2 Win
Lexie Klasing  	vs.	Adam Fronsee  	Player 2 Win
Jasiel Diez  	vs.	Darren Rennie  	Player 1 Win
Joshua Freeland  	vs.	Logan Perry  	Player 2 Win
Frank Karamaroudis  	vs.	Christian Ugaban  	Player 1 Win
Yuki Lee Bender  	vs.	Kyle Shull  	Player 1 Win
JUSTIN FRYAR  	vs.	Lorenzo Brambilla Pisoni  	Player 2 Win
Zach Dietz  	vs.	Chad Wischnewsky  	Player 2 Win
Jonny Espejo  	vs.	Philip Middleton  	Player 1 Win
AJ Brown  	vs.	Tony DeCaro  	Player 2 Win
Paul LE GOUEZ  	vs.	Alex Yun  	Player 1 Win
Christopher Yunck  	vs.	Tonin ''Nini'' Veshi  	Player 2 Win
Shane Martin  	vs.	Nathan Crawford  	Player 1 Win
Marco Jurakovich  	vs.	Erick Lofton  	Player 1 Win
Kevin Lindenmayer  	vs.	Edward Knight  	Player 2 Win
Alec Myers  	vs.	Anastasia Benner  	Player 2 Win
Tyler Meacher  	vs.	Nathaniel Snyder  	Player 2 Win
Michael McDowell  	vs.	Natalie Hunt  	Player 1 Win
Shimon Bandiel  	vs.	Douglas Levy  	Player 1 Win
Ben Cook  	vs.	Anthony DT Zichella  	Player 2 Win
Amber Zee  	vs.	Cindrah Moore  	Player 1 Win
Chenjun Liu  	vs.	Aidan Arruza  	Player 1 Win
Michael Bell  	vs.	Sean Biava  	Player 2 Win
Chandler To  	vs.	Jesse Machusak  	Player 1 Win
Shing Tsang  	vs.	Bryce Kesterson  	Player 1 Win
Scott Egan  	vs.	Tony Mapelli  	Player 2 Win
Keith Milde  	vs.	Adhy Kumar  	Player 1 Win
Steven Caraher  	vs.	AARON COLHOUER  	Player 1 Win
Christopher Higashi  	vs.	Carter Barton  	Player 2 Win
Kenneth Yan  	vs.	William Bradshaw  	Player 2 Win
Fredrick Gamble  	vs.	Christopher Saldana  	Player 2 Win
Quinn Wongkew  	vs.	Robbert Valkeneers  	Player 2 Win
Alex Slotnick  	vs.	Jonathan Lemire  	Player 2 Win
Jacob Clements  	vs.	Tim Seib  	Player 1 Win
Jamie Grantham  	vs.	Matt Rogers  	Player 2 Win
Andrew Goodwin  	vs.	Nick Bova  	Player 1 Win
Ciro Gambone  	vs.	Jamie Utley  	Player 1 Win
Jesus Montijo  	vs.	Bryce Henschel  	Player 2 Win
Jonas Stoberock  	vs.	Dexter Phan  	Player 2 Win
Adam Tran  	vs.	Max Small  	Player 2 Win
Paulo Fernandes  	vs.	Matthew Puckett  	Player 2 Win
Travis Woodward  	vs.	Kyle Gant  	Player 1 Win
Derek Chiu  	vs.	Walter Snowden  	Player 1 Win
Martin Hechtberger  	vs.	Jordan Brengartner  	Player 1 Win
Christian Weißling  	vs.	Robert Mills  	Player 1 Win
Stephen Perez  	vs.	Cameron Boutot  	Player 1 Win
Ian Smith  	vs.	Ravi Nehra  	Player 1 Win
Adam Green  	vs.	Jake Landaiche  	Player 1 Win
Isaac Brooks  	vs.	Justin Duszynski  	Player 1 Win
Joshua Rath  	vs.	Rob Sheridan  	Player 2 Win
Michael Ribar  	vs.	Matt Smith  	Player 1 Win
Bill Jargowsky  	vs.	Wyatt Goehring  	Player 1 Win
Caleb Broussard  	vs.	Brandon Green  	Player 2 Win
Thorbjørn Lind Jensen  	vs.	Andrew Wachter  	Player 1 Win
Brandon Fields  	vs.	Jeff Okrasinski  	Player 1 Win
Philippe Paquin  	vs.	Rodrigo Martinez  	Draw
Jeerod Balangan  	vs.	Bruno Cracco  	Player 1 Win
Katie Koslosky  	vs.	Erick Ortiz  	Player 2 Win
Tho Bui  	vs.	Will Pearce  	Player 2 Win
Gabriel Rasicot  	vs.	Michael Collins  	Player 2 Win
Mateusz Jasiński  	vs.	Robin Avenoso  	Player 2 Win
Steven Nemeth  	vs.	Brett Merold  	Player 1 Win
Lindsey Thiele  	vs.	Daniel Wolfe  	Player 2 Win
Mason Taylor  	vs.	Amber Pennington  	Player 1 Win
Tommy Hendricks  	vs.	Cory Lonas  	Player 1 Win
Adam Weaver  	vs.	Yuanji Li  	Player 2 Win
Tae Kim  	vs.	Daniel Smock  	Player 1 Win
Johnny Lam  	vs.	Eric Holmes  	Player 1 Win
Matthew Durci  	vs.	Robert Alonso  	Player 2 Win
George Ferris  	vs.	Andrew Melson  	Player 1 Win
David Mink  	vs.	Charles Simmons  	Player 2 Win
Majin Bae  	vs.	Christian Gerdes  	Player 1 Win
Menion Croll  	vs.	Tommy Golightly  	Player 1 Win
Kent Summerour  	vs.	Sasha Lang  	Player 2 Win
Adam Cook  	vs.	Leo Shea  	Player 1 Win
Mike DeNicola  	vs.	Tanya Wunder  	Player 2 Win
Jakub "Lemur" Siedlecki  	vs.	Sam Sutherland  	Player 2 Win
Addison Hudson  	vs.	Jasper Mork  	Player 1 Win
Shaheen Soorani  	vs.	Kyler Dustin  	Player 2 Win
Theodore Maximiuk  	vs.	Connor Matza  	Player 2 Win
Dustin LaFlamme  	vs.	Chris Ray  	Player 2 Win
Erik Johnson  	vs.	Ryan AuCoin  	Player 1 Win
JEREMY CHERNICK  	vs.	Jonathen Byrd  	Player 2 Win
Kevin Set  	vs.	Joshua Korovesi  	Player 2 Win
Owen Young  	vs.	Donald Kell  	Player 1 Win
Daniel Bellotti  	vs.	Aliasgar Dedanwala  	Player 2 Win
Mateusz Sass  	vs.	Will Reinhardt  	Player 1 Win
Taylor Nifong  	vs.	Brandon Flores  	Player 2 Win
Zackary Whitt  	vs.	Jake Woodward  	Player 2 Win
Leigh Pushard  	vs.	Devon Conn  	Player 1 Win
Jeffery Fredrickson  	vs.	Justin Addington  	Player 1 Win
Austin Tippen  	vs.	Bryce Johnson  	Player 2 Win
Peter Stanish  	vs.	Mark Tan  	Player 2 Win
David Brannen  	vs.	Sean Fox  	Player 2 Win
Alexander Benton  	vs.	Mike Euson  	Player 1 Win
Chris Legg  	vs.	Anderson Soares  	Player 2 Win
Paul Fortin  	vs.	Micah Perino  	Player 1 Win
Gary White  	vs.	Michael Fay  	Player 1 Win
Charles Poe  	vs.	Ben Hannan  	Player 1 Win
Christopher Dietz  	vs.	Alex Brown  	Player 2 Win
ANDREW WEBBER  	vs.	Riley Lont  	Player 1 Win
Michael Pawlak  	vs.	Andrew Bryant  	Player 2 Win
Arkadiusz "Rasaad" Sioda  	vs.	Emanuel Camacho  	Player 1 Win
Branden Voss  	vs.	Pierre-Nicolas Perrin  	Player 1 Win
Tyler Wolford  	vs.	Adrian Malana  	Player 2 Win
Jonas Benz  	vs.	Nigel Wunder  	Player 1 Win
Jonathan Walker  	vs.	Ryan Nenninger  	Player 1 Win
Michael Rutkowski  	vs.	Jackie Rousseau  	Player 2 Win
Brandon Bowden  	vs.	Hollis Eacho  	Draw
Aria How  	vs.	Samuel Ham  	Player 1 Win
Dustin Self  	vs.	anthony Petrillo  	Player 2 Win
Daniel Rothhaar  	vs.	Lee Conner  	Player 1 Win
James Warburton  	vs.	John Zapata  	Player 2 Win
BRENT ANDERSON  	vs.	Justin Cardoza  	Player 2 Win
Alexandre Lefebvre  	vs.	Travis Reeder  	Player 1 Win
Nicholas Santa  	vs.	Justin Balanca-Hawkes  	Player 1 Win
Ryan Goldfinger  	vs.	westley nottingham  	Player 2 Win
Rocky Cremeans  	vs.	William Euson  	Player 1 Win
Elijah Flanders  	vs.	Gabs Gable  	Player 1 Win
Jeremy Scruggs  	vs.	Hayley Neighbors  	Draw
Norman Bayliss  	vs.	Tom Evans  	Player 1 Win
Jonathan Wyatt  	vs.	Claire Stanfield  	Player 1 Win
Matthew Verderame  	vs.	Holden Isaacs  	Player 1 Win
TUCKER CAMPBELL  	vs.	Randall Suliga  	Player 2 Win
Dave Lin  	vs.	Ben Sharrin  	Player 1 Win
Ryan Levy  	vs.	Paul Deegan  	Player 1 Win
Shane Blake  	vs.	Joseph Bowers  	Player 1 Win
Chad Pennell  	vs.	Jonathan Julian  	Player 1 Win
Daniel Warner  	vs.	John Powell  	Player 1 Win
Matt Muus  	vs.	Marcus Brown  	Player 1 Win
Jason Brannick  	vs.	Sabastian Chizhik  	Player 2 Win
Benjamin Hannah  	vs.	Thaminda Edirisooriya  	Player 2 Win
Melissa Steinman  	vs.	Josef Mendez  	Player 2 Win
Mike Morelli  	vs.	VINAY SONI  	Player 2 Win
Spencer Freeman  	vs.	Kevin Guinn  	Player 1 Win
Elliot Bicker  	vs.	Alex Milam  	Player 1 Win
Liam Trodden  	vs.	Justin Matlack  	Player 1 Win
Jeffrey Lang  	vs.	Mitchell Blowey  	Player 2 Win
Matthew Terrell  	vs.	Nicholas Trotta  	Player 1 Win
Kevin Canales  	vs.	Eric Gorski  	Player 1 Win
Ross Fontana  	vs.	Bea Budnik  	Player 1 Win
Andrew Blackwell  	vs.	Logan Brushart  	Player 1 Win
Joshua Paris  	vs.	Piotr Krzempek  	Player 2 Win
Haik Voskerchian  	vs.	Jacob Hawkinson  	Player 2 Win
Jesus Garcia Gomez-Valades  	vs.	Erika Forslöf  	Player 1 Win
Anthony Cicchinelli  	vs.	Joseph Scalco  	Player 2 Win
Chad McKittrick  	vs.	Dexter Canright  	Player 2 Win
Brandon Salvatore  	vs.	Nicholas Mejac  	Player 2 Win
Mae French  	vs.	Caleb Zavits  	Player 1 Win
Michael Dorsey  	vs.	Caleb Womack  	Player 2 Win
Justin Salmon  	vs.	Ryan Barnett  	Player 1 Win
Justin Liwag  	vs.	Thomas Mottram  	Player 1 Win
Devin Bell  	vs.	William Bodo  	Player 1 Win
Chad Emerick  	vs.	BRAD ALLRED  	Player 2 Win
Kevin Fontan  	vs.	Adrian Gebhart  	Player 2 Win
Blake Lococo  	vs.	Timothy Wells  	Player 2 Win
Jordan Self  	vs.	Chad Allred  	Player 1 Win
Anthony Herzog  	vs.	Viet Pham  	Player 1 Win
Hendrik Wytze Kluitenberg  	vs.	Justin Sybrandt  	Player 2 Win
George Panageotou  	vs.	Justin Hill  	Player 2 Win
Anthony Laflamme  	vs.	Dayna Hagewood  	Player 2 Win
Zach Allen  	vs.	Rowsendo Nelson  	Player 1 Win
Lee Maring  	vs.	Carl Norman  	Player 2 Win
Blake Godenzi  	vs.	Jordan Biggs  	Player 1 Win
Felipe Costa Batista  	vs.	Robert Postlewaite  	Player 2 Win
David Reitenbach  	vs.	Nicholas Snyder  	Player 1 Win
James Cæruleus Silver  	vs.	Eric Shoopman  	Player 2 Win
Alberto Ruiz  	vs.	RONNY MARTIN  	Player 2 Win
Tristan Mitchell  	vs.	Matthew Fay  	Player 2 Win
Andrew Ali  	vs.	Jonah Overholt  	Player 2 Win
David Lee  	vs.	Brandon Datwyler  	Player 1 Win
James Thourgood  	vs.	Brandon Canedy  	Player 2 Win
Ricky Perez  	vs.	Nathaniel Meserve  	Player 2 Win
Andre Belote  	vs.	Donovan Mitchell  	Player 1 Win
Alexander Hempelmann  	vs.	Mitchel Tobey  	Player 1 Win
Nathan Gardner  	vs.	Kolbrun Palsdottir  	Player 1 Win
Thomas Jaszczur  	vs.	Jason Irons  	Player 1 Win
Fuzzy Delp  	vs.	Ian Shaffer  	Player 1 Win
Vincent Gambone  	vs.	Brandan St. Amour  	Player 1 Win
Aidan Berkel  	vs.	Olivia Yauger  	Player 1 Win
William Pate  	vs.	Jacob Hudson  	Player 1 Win
Peter Zsiga  	vs.	June Aino  	Player 2 Win
Nick Webb  	vs.	Ethan Bridges  	Player 2 Win
Daniel Link  	vs.	David Sitrick  	Player 2 Win
Adam Roark  	vs.	Eugene Schaefer  	Player 1 Win
Michael McDermott  	vs.	Donovan Wilcox  	Player 1 Win
Andrew Lundeen  	vs.	Kenny Thai  	Player 1 Win
Guillem Las Heras Aixandri  	vs.	Jake Griffin  	Player 1 Win
Zachary Sweigart  	vs.	Nicholas Hoover  	Player 2 Win
Dakota Scales  	vs.	Alexander Choiniere  	Player 2 Win
Matt Jacobs  	vs.	Kyle Meserve  	Player 2 Win
Colton Miller  	vs.	Shawn Sapiel  	Player 1 Win
Skyler Cady  	vs.	Jesse Shaw  	Player 1 Win
Pete Stalker  	vs.	Henry Robichaux  	Player 2 Win
Allison Oram  	vs.	Jared Wyce  	Player 1 Win
Ryan Fox  	vs.	Ridgely Fahey  	Player 1 Win
Kyle Thiele  	vs.	Zachary Campos  	Player 1 Win
Tyler Goodridge  	vs.	Walker Stephens  	Player 1 Win
Jacob Kurka  	vs.	Desmond Lee  	Player 1 Win
Dakota Cook  	vs.	Gabriel Marengo  	Player 2 Win
Alek Idol  	vs.	brynn nieboer  	Draw
Catherine Powell  	vs.	Gwyndolin Newbill  	Player 1 Win
Matt Mills  	vs.	Ethan Kirychuk  	Player 1 Win
Andrew MacNamee  	vs.	Eric Dauernnheim  	Player 2 Win
Daniel Davila  	vs.	Ethan Mitchell  	Player 2 Win
Will Rea  	vs.	Airton dos Santos Junior  	Player 2 Win
Kashiem Brown  	vs.	Erick Boeder  	Player 2 Win
Bartosz Dominiak  	vs.	Brandon Crawford  	Player 1 Win
Chris Rowland  	vs.	Richard Whipkey  	Player 1 Win
Artie Hamelin  	vs.	Tomasz Buda  	Player 1 Win
Andrew Mellina  	vs.	Julian Helgeson  	Player 1 Win
Garrett Shustarich  	vs.	Heather Fechter  	Player 1 Win
Devin Rattenni  	vs.	Sam (Real) Yuen  	Player 2 Win
Andy Portillo  	vs.	Case Johnson  	Player 2 Win
Ashley Babiarz  	vs.	Darick Oswalt  	Player 2 Win
Jonathan Price  	vs.	Tessa Myers  	Player 2 Win
Dennis Mullins  	vs.	Floris van Asch  	Player 1 Win
Noah Geiger  	vs.	Long Dao  	Player 1 Win
Mark sipics  	vs.	Anthony Domalakes  	Player 1 Win
Gerald Camangon  	vs.	Evan McGrew  	Player 2 Win
Everett Irby  	vs.	Andrew Shafer  	Player 1 Win
Nicolas Bouffard  	vs.	Alan Chavarin  	Player 1 Win
Ashton Riggs  	vs.	James Smith  	Player 2 Win
Colin Ross  	vs.	Kyle Peterson  	Player 1 Win
Lucas Barding  	vs.	Ryan Castilla  	Player 2 Win
Dylon Brown  	vs.	Jonathan Seaborn  	Player 2 Win
Joshua Levy  	vs.	Douglas Maclure  	Player 1 Win
Dennis Pham  	vs.	Russell Hedlund  	Player 1 Win
Derek Zellner  	vs.	Caleb Nelson  	Player 2 Win
Tuomas Kainulainen  	vs.	Jason VanBuskirk  	Player 1 Win
Spencer Fritts  	vs.	Lucas Codato Antonio Silva  	Player 1 Win
Michael Popowich  	vs.	Josh Campos  	Player 1 Win
Conner Holtgreive  	vs.	Corey Watson  	Player 2 Win
James Tague  	vs.	Manuel Rosario  	Player 1 Win
Tracy Reeves  	vs.	Tanner DeMarco  	Player 2 Win
Jordan Blankenship  	vs.	James Prince  	Player 1 Win
Sara Smith  	vs.	Dylan Vanpatten  	Player 1 Win
Derek Byrne  	vs.	Abbas Dedanwala  	Player 2 Win
Michael Cusick  	vs.	Darius Hambleton  	Player 2 Win
Brandon Gehron  	vs.	Luis Maderas  	Player 2 Win
Greg Mitchell  	vs.	Jorge Gonzalez  	Player 1 Win
Chris Kern  	vs.	Zoey Gerstner  	Player 2 Win
Jason Price II  	vs.	Gregory Price  	Player 2 Win
Michael Tucci  	vs.	Joseph Cicchini  	Player 1 Win
Justin Harris  	vs.	Michael Causey  	Player 2 Win
Nicholas Brown  	vs.	Eric LaGaccia  	Player 1 Win
Cooper Pemelton  	vs.	Mara Richard  	Player 1 Win
Tatiana Parada  	vs.	None	Player 1 Win
Connor Talty  	vs.	Chase Reiser  	Player 1 Win
Michael DeBoard  	vs.	None	Player 1 Win
#####
Davide Abis  	vs.	Peyton Sayasith  	Player 2 Win
Austin Kim  	vs.	Chris Fazio  	Player 1 Win
Joshua Kehe  	vs.	Ryan Garris  	Player 2 Win
James Adams  	vs.	Nathanael Hunt  	Player 1 Win
Chuck Hutchins  	vs.	Jesse Harper  	Player 1 Win
Nicholas Porter  	vs.	Yan Garito  	Player 2 Win
Clay DeAngelis  	vs.	Philip Parker  	Player 2 Win
Zach Bunn  	vs.	Tyler Brotton  	Player 2 Win
Connor Bryant  	vs.	Dylan Ashcraft  	Player 2 Win
Jacob Kissel  	vs.	Derek Copp  	Player 1 Win
Darryl Thompson  	vs.	Sam OByrne  	Player 1 Win
Ian Daryl Bon  	vs.	Joel Grizzelle  	Player 1 Win
Raj Parikh  	vs.	William Pearlman  	Player 1 Win
Bryan Kong  	vs.	Colin Swisher  	Player 2 Win
Merrick Kemp  	vs.	Jonathan (chugs) Moore  	Player 1 Win
Tee Thebeau  	vs.	Andrew Nguyen  	Player 1 Win
Michael Lau  	vs.	Dylan Myers  	Player 2 Win
Eli Teed  	vs.	Jack Stoney  	Player 2 Win
Seth Penner  	vs.	nicolas Jamoulle  	Player 2 Win
Jeff Thompson  	vs.	Daniel Rutkowski  	Player 1 Win
Jie ma  	vs.	Levi Rauch  	Player 1 Win
Brennan Tolnay  	vs.	Tanner Propst  	Player 2 Win
Joshua Lovell  	vs.	Anthony Cerenzio  	Player 1 Win
Andrew Henderson  	vs.	Maciej Chmielewski  	Player 1 Win
Thomas Coleman  	vs.	Daniel Ferrara  	Player 2 Win
Lucas Bannigan  	vs.	Matthew VanPatten  	Player 1 Win
Daniel Wolff  	vs.	Paul Naughton  	Player 2 Win
Emery Powell  	vs.	Trenton McBride  	Player 1 Win
Matthew W  	vs.	Thomas Hood  	Player 1 Win
Matt Garner  	vs.	Matt MacLeod  	Player 2 Win
Daniel Correas  	vs.	Roger Bodee  	Player 1 Win
Zdeněk Matura  	vs.	Jake Wenger  	Player 2 Win
Marcelo Gazzaneo  	vs.	Jonathan Richards  	Player 1 Win
Lucas Molho  	vs.	Taylor Crawford  	Player 2 Win
Donovan van Beek  	vs.	Timothy Long  	Player 1 Win
Damien Riggins  	vs.	Louis Solymos  	Player 2 Win
Dan Mui  	vs.	Lee Kimball  	Player 1 Win
Shawn Adams  	vs.	Samuel Hershey  	Player 2 Win
Kyle Eckenrode  	vs.	Eric Cortez omana  	Player 2 Win
Philip van Donselaar  	vs.	connor rooney  	Player 1 Win
Jonathan Magnuson  	vs.	Dave Cordeiro  	Player 1 Win
Jeremy Langevin  	vs.	Jacob Lantz  	Player 1 Win
Michael Toryk  	vs.	Paul White  	Player 2 Win
Elijah Calub  	vs.	DYLAN MANGINI  	Player 2 Win
Ren Fisk  	vs.	Jeremiah Gardner  	Player 1 Win
Mariusz Suchanecki  	vs.	Jacob Baugh  	Player 2 Win
Joel Repta  	vs.	Oliver Phi  	Player 2 Win
Randall Sims  	vs.	Marvin Dominguez  	Player 1 Win
Alex Ptak  	vs.	Bun Ar  	Player 1 Win
Frank Karamaroudis  	vs.	Timothy Scroggs  	Player 2 Win
Chris Martin  	vs.	David Trinh  	Player 2 Win
Patrick Yoder  	vs.	John Colvin  	Player 2 Win
Patrick Shaw  	vs.	Max Dieckmann  	Player 2 Win
Dylan Williamson  	vs.	Kyle Hebert  	Draw
Matthew Holinaty  	vs.	Brandon Bianco  	Player 1 Win
Sebastian Russell  	vs.	Julian Sniffen  	Player 2 Win
Kyle Richards  	vs.	Sean Fox  	Player 2 Win
Jacob Milam  	vs.	Piotr Krzempek  	Player 2 Win
The Better Johnson  	vs.	Zack Phillips  	Player 1 Win
Joshua Himmelberger  	vs.	Nicholas Costanzo  	Player 2 Win
Franche Tan  	vs.	Chris Ray  	Player 2 Win
Logan Petersen  	vs.	Travis Woodward  	Player 2 Win
John Wardan  	vs.	Fuzzy Delp  	Player 2 Win
Matthew Halstad  	vs.	Julian Felix Flury  	Player 2 Win
Tyler Kerch  	vs.	Todd Rowe  	Player 2 Win
Ashley Yvette Bellevue  	vs.	Ciro Gambone  	Player 2 Win
Porter Jones  	vs.	Vlastimil Martinek Jr.  	Player 2 Win
ryan moran  	vs.	Johnny Lam  	Player 1 Win
Alex Broussard  	vs.	Bradley Tashman  	Player 2 Win
Brandon Akers  	vs.	Robert Alonso  	Player 2 Win
Skyler Lewis  	vs.	Thomas Briggs  	Player 2 Win
Zachry Benz  	vs.	Adam Fronsee  	Player 1 Win
Spencer Beck  	vs.	Rylie Groff  	Player 1 Win
Michael Lynch  	vs.	Luke Magnuson  	Player 1 Win
Madison Theriault  	vs.	Adrian Malana  	Player 1 Win
Ian Olson  	vs.	Aria How  	Player 2 Win
Justin Gottlieb  	vs.	Zach Allen  	Player 1 Win
Camilo Herrera  	vs.	Ovas Siddiqui  	Player 2 Win
Martin Schelasin  	vs.	Joshua Korovesi  	Player 1 Win
Matthew Cudney  	vs.	Michael Collins  	Player 1 Win
Aidan O'Sullivan  	vs.	Tanya Wunder  	Player 2 Win
Steven Rodriguez  	vs.	Jonathan Wyatt  	Player 1 Win
Andre Maldonado  	vs.	Bastien Le Guen  	Player 2 Win
Patrick Nelson  	vs.	Aiden Dee  	Player 2 Win
Mathew Frye  	vs.	Tristan Hanson  	Player 1 Win
Sean Moyer  	vs.	Ross Fontana  	Player 1 Win
Cole Pellatt  	vs.	Mitchell Blowey  	Player 1 Win
Jodey Burney  	vs.	Dyllon Dietz  	Player 1 Win
Fabio Rego  	vs.	Justin Rowland  	Player 1 Win
Fernando Caprino  	vs.	Nathaniel Meserve  	Player 1 Win
Dennis Zhang  	vs.	Christian Weißling  	Player 1 Win
Benjamin Hebert  	vs.	Nicholas Santa  	Player 1 Win
Bobby Jarboe  	vs.	Mateusz Sass  	Player 2 Win
Darren Black  	vs.	Randall Suliga  	Player 2 Win
Wilson Badillo  	vs.	Tony DeCaro  	Player 1 Win
Aaron Guy  	vs.	Sean Biava  	Player 2 Win
Joshua Lau  	vs.	Charles Simmons  	Player 1 Win
Gregory Patellis  	vs.	Justin Cardoza  	Player 1 Win
Nick Tucker  	vs.	Alexandre Lefebvre  	Player 1 Win
Corey Baker  	vs.	Shane Martin  	Player 1 Win
Alexander Wolfe  	vs.	David Lee  	Player 2 Win
Grant Kern  	vs.	Shimon Bandiel  	Player 2 Win
Brian McLachlin  	vs.	Andrew Bryant  	Player 2 Win
Phillip Manwaring  	vs.	Thomas Jaszczur  	Player 1 Win
Evan Zumwalt  	vs.	Derek Chiu  	Player 2 Win
jamie bithell  	vs.	Christopher Saldana  	Player 1 Win
Alex Sneed  	vs.	Gordon Koh Koh  	Player 1 Win
Alex Tyler  	vs.	Haukur Thor Buason  	Player 2 Win
Ryan Thomas  	vs.	joseph lawson  	Player 1 Win
Corey Waugh  	vs.	Elijah Flanders  	Player 2 Win
Kenneth Justin  	vs.	Gabe Sher  	Player 2 Win
Aaron Grace  	vs.	Rocky Cremeans  	Player 1 Win
Sage Husanu  	vs.	Jonathan Lemire  	Player 2 Win
Leonardo Pessôa  	vs.	Anthony Chiechi  	Player 1 Win
Nick Allen  	vs.	Joseph Scalco  	Player 2 Win
John Romah  	vs.	Connor Matza  	Player 1 Win
Parker Longwell  	vs.	David Letourneau  	Player 2 Win
Derek Anderson  	vs.	Paul LE GOUEZ  	Player 2 Win
Sebastian Spicher  	vs.	Addison Hudson  	Player 1 Win
Dmitry Sorokin  	vs.	Kevin Brayer  	Player 1 Win
ry mo  	vs.	James Swain  	Player 1 Win
Chad Bortz  	vs.	Justin Sybrandt  	Player 2 Win
Michael Strianese  	vs.	nicklas starland  	Player 2 Win
Nils Klaper  	vs.	Mason Taylor  	Player 1 Win
Matt Davey  	vs.	Jose Santos martinez  	Player 1 Win
Pascal Weiler  	vs.	Daniel Rothhaar  	Player 2 Win
Cooper Templeton  	vs.	Adam Cook  	Player 1 Win
George Rodger  	vs.	Logan Perry  	Player 1 Win
Adam Jessell  	vs.	Daniel Warner  	Player 1 Win
Mitchell Tillery  	vs.	Adrian Słowiński  	Player 2 Win
Ektor Angelomatis  	vs.	Branden Voss  	Player 2 Win
Joshua Tavares  	vs.	Kevin Canales  	Player 2 Win
Tom Philippi  	vs.	Chris Brummett  	Player 2 Win
Kevin Tran  	vs.	Jonah Overholt  	Player 1 Win
Nam Vo  	vs.	Jackie Rousseau  	Player 2 Win
Ryan Wolohan  	vs.	James Wray  	Player 1 Win
Sean Davis  	vs.	Matthew Verderame  	Player 1 Win
Michael Riddle  	vs.	Jonny Espejo  	Player 2 Win
Albert Schütt  	vs.	Anastasia Benner  	Player 2 Win
Amber Zee  	vs.	Adrian Gebhart  	Player 2 Win
Tony Mapelli  	vs.	Chenjun Liu  	Player 2 Win
Rafaelo "Ruffy" Sarmiento  	vs.	Matthew Terrell  	Player 1 Win
Yuki Lee Bender  	vs.	John Zapata  	Player 1 Win
Michael Ribar  	vs.	Bill Jargowsky  	Player 2 Win
Bryce Henschel  	vs.	Rob Sheridan  	Player 2 Win
Brandon Green  	vs.	Timothy Wells  	Player 2 Win
Brandon Fields  	vs.	Michael McDowell  	Player 1 Win
Jeerod Balangan  	vs.	Dave Lin  	Player 2 Win
Nathaniel Snyder  	vs.	Daniel Wolfe  	Player 2 Win
Martin Hechtberger  	vs.	Josef Mendez  	Player 1 Win
Keith Milde  	vs.	Shane Blake  	Player 1 Win
Andrew Goodwin  	vs.	anthony Petrillo  	Player 1 Win
Luke Shinn  	vs.	Liam Trodden  	Player 2 Win
Stephen Perez  	vs.	George Ferris  	Player 2 Win
Thorbjørn Lind Jensen  	vs.	Shing Tsang  	Player 1 Win
Chandler To  	vs.	Alex Brown  	Player 1 Win
Adam Green  	vs.	Mae French  	Player 2 Win
Isaac Brooks  	vs.	Ryan Levy  	Player 1 Win
Jasiel Diez  	vs.	Sasha Lang  	Player 1 Win
Marco Jurakovich  	vs.	Gary White  	Player 2 Win
Alexander Benton  	vs.	Dexter Phan  	Player 1 Win
Arkadiusz "Rasaad" Sioda  	vs.	Ian Smith  	Player 2 Win
Matt Muus  	vs.	Lorenzo Brambilla Pisoni  	Player 2 Win
Matthew Steeves  	vs.	ANDREW WEBBER  	Player 2 Win
Charles Poe  	vs.	Nathan Gardner  	Player 2 Win
Steven Caraher  	vs.	Menion Croll  	Player 1 Win
Jacob Clements  	vs.	Max Small  	Player 1 Win
Isaac Rancic  	vs.	Jake Woodward  	Player 1 Win
westley nottingham  	vs.	Michael DeBoard  	Player 2 Win
Jonathen Byrd  	vs.	Eric Shoopman  	Player 2 Win
Aliasgar Dedanwala  	vs.	Mark Tan  	Player 1 Win
Robbert Valkeneers  	vs.	Will Pearce  	Player 1 Win
Norman Bayliss  	vs.	Tommy Hendricks  	Player 1 Win
Anderson Soares  	vs.	Tae Kim  	Player 2 Win
Owen Young  	vs.	Jonathan Walker  	Player 2 Win
Paul Fortin  	vs.	Andre Belote  	Player 2 Win
Chad Pennell  	vs.	Andrew Blackwell  	Player 1 Win
Matt Rogers  	vs.	Edward Knight  	Player 1 Win
Matthew Puckett  	vs.	Anthony DT Zichella  	Player 2 Win
Steven Nemeth  	vs.	Blake Godenzi  	Player 2 Win
Majin Bae  	vs.	Leigh Pushard  	Player 1 Win
Erik Johnson  	vs.	VINAY SONI  	Player 1 Win
Jeffery Fredrickson  	vs.	Carter Barton  	Player 1 Win
Jonas Benz  	vs.	Thaminda Edirisooriya  	Player 2 Win
Tonin ''Nini'' Veshi  	vs.	Elliot Bicker  	Player 1 Win
Spencer Freeman  	vs.	RONNY MARTIN  	Player 2 Win
Robin Avenoso  	vs.	David Reitenbach  	Player 2 Win
Jacob Balgoyen  	vs.	Anthony Herzog  	Player 2 Win
Justin Salmon  	vs.	Jesus Garcia Gomez-Valades  	Player 1 Win
Dexter Canright  	vs.	Kyler Dustin  	Player 1 Win
Sam Sutherland  	vs.	Aidan Berkel  	Player 2 Win
Chad Wischnewsky  	vs.	Brandon Canedy  	Player 2 Win
Yuanji Li  	vs.	Brandon Flores  	Player 1 Win
Trent Lennon  	vs.	Matthew Fay  	Player 1 Win
Jordan Self  	vs.	Dayna Hagewood  	Player 1 Win
Devin Bell  	vs.	Nicholas Mejac  	Player 1 Win
Carl Norman  	vs.	Vincent Gambone  	Player 1 Win
Justin Hill  	vs.	Alexander Hempelmann  	Player 2 Win
BRAD ALLRED  	vs.	Justin Liwag  	Player 2 Win
Jacob Hawkinson  	vs.	Erick Ortiz  	Player 2 Win
Caleb Womack  	vs.	Bryce Johnson  	Player 1 Win
Robert Postlewaite  	vs.	Sabastian Chizhik  	Player 2 Win
William Bradshaw  	vs.	Artie Hamelin  	Player 2 Win
Philippe Paquin  	vs.	Michael Pawlak  	Player 1 Win
Carson Osborne  	vs.	Garrett Shustarich  	Player 1 Win
Jenna Schoettker  	vs.	William Pate  	Player 2 Win
Brandon Bowden  	vs.	Adam Tran  	Player 2 Win
Rodrigo Martinez  	vs.	Kyle Shull  	Player 2 Win
Jeremy Scruggs  	vs.	Keegan Wolohan  	Player 2 Win
Bryan Knecht  	vs.	Michael Causey  	Player 1 Win
Hayley Neighbors  	vs.	Devon Conn  	Player 1 Win
Joshua Freeland  	vs.	Christopher Higashi  	Player 1 Win
Tyler Meacher  	vs.	Nick Bova  	Player 2 Win
Quinn Wongkew  	vs.	Ryan Barnett  	Player 2 Win
Jonas Stoberock  	vs.	Hollis Eacho  	Player 1 Win
Caleb Broussard  	vs.	Nicholas Trotta  	Player 1 Win
Zach Dietz  	vs.	Matt Mills  	Player 1 Win
Ben Cook  	vs.	Chris Legg  	Player 2 Win
Michael Bell  	vs.	AARON COLHOUER  	Player 2 Win
Kevin Lindenmayer  	vs.	JEREMY CHERNICK  	Player 2 Win
Mike Morelli  	vs.	Pierre-Olivier Vallerand Beaudry  	Player 1 Win
Christopher Yunck  	vs.	Jordan Blankenship  	Player 1 Win
Tristan Kilper  	vs.	Tim Seib  	Player 2 Win
Fredrick Gamble  	vs.	Hendrik Wytze Kluitenberg  	Player 2 Win
Alec Myers  	vs.	James Tague  	Player 1 Win
Paulo Fernandes  	vs.	Ravi Nehra  	Player 1 Win
Nathan Crawford  	vs.	Andrew Mellina  	Player 1 Win
JUSTIN FRYAR  	vs.	Lexie Klasing  	Player 1 Win
Kenneth Yan  	vs.	Noah Geiger  	Player 2 Win
Matthew Durci  	vs.	Jeff Okrasinski  	Player 1 Win
Jordan Brengartner  	vs.	Sam (Real) Yuen  	Player 2 Win
Mike DeNicola  	vs.	Christopher Dietz  	Player 2 Win
Theodore Maximiuk  	vs.	Joshua Rath  	Player 2 Win
BRENT ANDERSON  	vs.	Tyler Goodridge  	Player 1 Win
David Hopson  	vs.	Brandon Salvatore  	Player 1 Win
Daniel Collett  	vs.	Kevin Fontan  	Player 1 Win
Katie Koslosky  	vs.	Dennis Pham  	Player 2 Win
Anthony Gascon  	vs.	Amber Pennington  	Player 1 Win
Scott Egan  	vs.	John Powell  	Player 1 Win
Jesus Montijo  	vs.	Jordan Biggs  	Player 2 Win
Alex Slotnick  	vs.	Samuel Ham  	Player 1 Win
Cameron Boutot  	vs.	Guillem Las Heras Aixandri  	Player 2 Win
Andrew Wachter  	vs.	Catherine Powell  	Player 1 Win
Leo Shea  	vs.	Marcus Brown  	Player 2 Win
Robert Mills  	vs.	Zackary Whitt  	Player 1 Win
Alexander Karlson  	vs.	Jakub "Lemur" Siedlecki  	Player 2 Win
Kevin Set  	vs.	Michael Dorsey  	Player 1 Win
Adhy Kumar  	vs.	Haik Voskerchian  	Player 2 Win
Natalie Hunt  	vs.	Thomas Mottram  	Player 2 Win
Ryan Goldfinger  	vs.	Luis Maderas  	Player 2 Win
Holden Isaacs  	vs.	Taylor Nifong  	Player 2 Win
Walter Snowden  	vs.	Greg Mitchell  	Player 2 Win
William Euson  	vs.	Zoey Gerstner  	Player 1 Win
Gabs Gable  	vs.	Ben Sharrin  	Player 2 Win
Tom Evans  	vs.	Nicolas Bouffard  	Player 1 Win
Cindrah Moore  	vs.	Jamie Utley  	Player 2 Win
Tho Bui  	vs.	Lee Conner  	Player 1 Win
Gabriel Rasicot  	vs.	Justin Balanca-Hawkes  	Player 2 Win
Tyler Wolford  	vs.	Matt Smith  	Player 2 Win
Mateusz Jasiński  	vs.	Brandan St. Amour  	Player 1 Win
Benjamin Hannah  	vs.	Colin Ross  	Player 2 Win
David Brannen  	vs.	Caleb Zavits  	Player 1 Win
Daniel Bellotti  	vs.	Michael Popowich  	Player 1 Win
Douglas Levy  	vs.	Tatiana Parada  	Player 1 Win
James Warburton  	vs.	Tanner DeMarco  	Player 1 Win
Philip Middleton  	vs.	Justin Matlack  	Player 1 Win
Will Reinhardt  	vs.	Kyle Meserve  	Player 2 Win
Joseph Bowers  	vs.	Connor Talty  	Player 1 Win
Melissa Steinman  	vs.	Brandon Datwyler  	Player 1 Win
Travis Reeder  	vs.	Tommy Golightly  	Player 1 Win
Lindsey Thiele  	vs.	Nicholas Snyder  	Player 2 Win
Adam Weaver  	vs.	Daniel Smock  	Player 1 Win
David Mink  	vs.	Paul Deegan  	Player 1 Win
Shaheen Soorani  	vs.	Pierre-Nicolas Perrin  	Player 2 Win
Dustin LaFlamme  	vs.	Justin Duszynski  	Player 2 Win
Austin Tippen  	vs.	Christian Gerdes  	Player 1 Win
Peter Stanish  	vs.	Christian Ugaban  	Player 2 Win
Michael Rutkowski  	vs.	Darren Rennie  	Player 1 Win
TUCKER CAMPBELL  	vs.	Viet Pham  	Player 1 Win
Jason Brannick  	vs.	James Smith  	Player 2 Win
Kent Summerour  	vs.	Andrew Ali  	Player 1 Win
Jeffrey Lang  	vs.	Spencer Fritts  	Player 2 Win
Chase Reiser  	vs.	Cooper Pemelton  	Player 2 Win
Joshua Paris  	vs.	June Aino  	Player 1 Win
Mike Euson  	vs.	Anthony Cicchinelli  	Player 2 Win
Chad McKittrick  	vs.	Jake Landaiche  	Player 2 Win
Erika Forslöf  	vs.	Chad Allred  	Player 1 Win
Logan Brushart  	vs.	Sara Smith  	Player 2 Win
Justin Addington  	vs.	Allison Oram  	Player 1 Win
Brett Merold  	vs.	Evan McGrew  	Player 1 Win
Michael Fay  	vs.	William Bodo  	Player 2 Win
Bruno Cracco  	vs.	Emanuel Camacho  	Player 1 Win
Nigel Wunder  	vs.	Kyle Gant  	Player 2 Win
Alberto Ruiz  	vs.	Blake Lococo  	Player 2 Win
Tristan Mitchell  	vs.	George Panageotou  	Player 1 Win
Lee Maring  	vs.	Corey Watson  	Player 1 Win
James Cæruleus Silver  	vs.	Jacob Kurka  	Player 2 Win
Aidan Kwasneski  	vs.	Ethan Bridges  	Player 2 Win
James Thourgood  	vs.	Mark sipics  	Player 1 Win
Rowsendo Nelson  	vs.	Alexander Choiniere  	Player 1 Win
Kevin Guinn  	vs.	Ian Shaffer  	Player 2 Win
Eric Holmes  	vs.	Eric Gorski  	Player 1 Win
Jonathan Julian  	vs.	Adam Roark  	Player 2 Win
Andrew Melson  	vs.	Abbas Dedanwala  	Player 1 Win
Ryan AuCoin  	vs.	Bryce Kesterson  	Player 2 Win
Jasper Mork  	vs.	Dennis Mullins  	Player 1 Win
Riley Lont  	vs.	Donald Kell  	Player 2 Win
Felipe Costa Batista  	vs.	Joshua Levy  	Player 2 Win
Wyatt Goehring  	vs.	Alex Milam  	Player 1 Win
Alex Yun  	vs.	Michael Tucci  	Player 2 Win
Cory Lonas  	vs.	Michael McDermott  	Player 1 Win
Aidan Arruza  	vs.	David Sitrick  	Player 1 Win
Erick Lofton  	vs.	Gabriel Marengo  	Player 2 Win
Micah Perino  	vs.	Gregory Price  	Player 2 Win
Jesse Machusak  	vs.	Colton Miller  	Draw
Ricky Perez  	vs.	Jason Irons  	Player 1 Win
Kolbrun Palsdottir  	vs.	Ryan Castilla  	Player 1 Win
Olivia Yauger  	vs.	Kyle Thiele  	Player 2 Win
Tyler Kaminskie  	vs.	Darick Oswalt  	Player 1 Win
Ryan Nenninger  	vs.	Erick Boeder  	Player 2 Win
Mitchel Tobey  	vs.	Nicholas Hoover  	Player 2 Win
Andrew Lundeen  	vs.	Case Johnson  	Player 2 Win
Skyler Cady  	vs.	Jonathan Seaborn  	Player 2 Win
Ryan Fox  	vs.	Chris Rowland  	Player 2 Win
Bartosz Dominiak  	vs.	Henry Robichaux  	Player 1 Win
Airton dos Santos Junior  	vs.	Caleb Nelson  	Player 2 Win
Ethan Mitchell  	vs.	Tessa Myers  	Player 1 Win
Eric Dauernnheim  	vs.	Nicholas Brown  	Player 1 Win
Darius Hambleton  	vs.	Brandon Crawford  	Player 2 Win
Alek Idol  	vs.	Walker Stephens  	Player 1 Win
Nick Webb  	vs.	Alan Chavarin  	Player 2 Win
Daniel Link  	vs.	Anthony Domalakes  	Player 1 Win
Dakota Scales  	vs.	Mara Richard  	Player 1 Win
Matt Jacobs  	vs.	James Prince  	Player 1 Win
Zachary Sweigart  	vs.	Andrew MacNamee  	Player 1 Win
Jesse Shaw  	vs.	Ashley Babiarz  	Player 1 Win
Pete Stalker  	vs.	Jared Wyce  	Player 1 Win
Will Rea  	vs.	Kenny Thai  	Player 1 Win
Kashiem Brown  	vs.	Michael Cusick  	Player 2 Win
Gerald Camangon  	vs.	Shawn Sapiel  	Player 1 Win
Daniel Davila  	vs.	Gwyndolin Newbill  	Player 1 Win
Ridgely Fahey  	vs.	Kyle Peterson  	Player 2 Win
Jacob Hudson  	vs.	Josh Campos  	Player 2 Win
Conner Holtgreive  	vs.	Justin Harris  	Player 1 Win
Zachary Campos  	vs.	Manuel Rosario  	Player 2 Win
Richard Whipkey  	vs.	Joseph Cicchini  	Player 2 Win
Andrew Shafer  	vs.	Ethan Kirychuk  	Player 2 Win
Russell Hedlund  	vs.	Lucas Codato Antonio Silva  	Player 2 Win
Jorge Gonzalez  	vs.	Chris Kern  	Player 2 Win
Donovan Wilcox  	vs.	Desmond Lee  	Player 1 Win
#####
Darryl Thompson  	vs.	Ian Daryl Bon  	Player 1 Win
Jie ma  	vs.	Philip Parker  	Player 2 Win
Austin Kim  	vs.	Matt MacLeod  	Player 2 Win
James Adams  	vs.	Tanner Propst  	Player 1 Win
Joshua Lovell  	vs.	Jack Stoney  	Player 2 Win
Lucas Bannigan  	vs.	Tyler Brotton  	Player 1 Win
Raj Parikh  	vs.	Tee Thebeau  	Player 2 Win
Merrick Kemp  	vs.	Jeff Thompson  	Player 2 Win
Chuck Hutchins  	vs.	Emery Powell  	Player 2 Win
Jacob Kissel  	vs.	Peyton Sayasith  	Player 1 Win
Taylor Crawford  	vs.	Philip van Donselaar  	Player 1 Win
Donovan van Beek  	vs.	Timothy Scroggs  	Player 1 Win
Jeremy Langevin  	vs.	Louis Solymos  	Player 1 Win
Paul Naughton  	vs.	Matthew W  	Player 2 Win
Colin Swisher  	vs.	Jake Wenger  	Player 1 Win
Marcelo Gazzaneo  	vs.	Eric Cortez omana  	Player 1 Win
Andrew Henderson  	vs.	Dylan Myers  	Player 1 Win
Dan Mui  	vs.	John Colvin  	Player 2 Win
Paul White  	vs.	DYLAN MANGINI  	Player 2 Win
Randall Sims  	vs.	Max Dieckmann  	Player 2 Win
Daniel Correas  	vs.	Alex Ptak  	Player 1 Win
David Trinh  	vs.	Dylan Ashcraft  	Player 2 Win
Jonathan Magnuson  	vs.	Daniel Ferrara  	Player 1 Win
Yan Garito  	vs.	Ren Fisk  	Player 1 Win
Jacob Baugh  	vs.	nicolas Jamoulle  	Player 2 Win
Ryan Garris  	vs.	Oliver Phi  	Player 2 Win
Samuel Hershey  	vs.	Chris Fazio  	Player 2 Win
Dylan Williamson  	vs.	Aidan Berkel  	Player 1 Win
Clay DeAngelis  	vs.	Kevin Tran  	Player 1 Win
Joshua Kehe  	vs.	Timothy Long  	Player 2 Win
Nicholas Porter  	vs.	Fuzzy Delp  	Player 1 Win
Zach Bunn  	vs.	Majin Bae  	Player 1 Win
Nathanael Hunt  	vs.	Aiden Dee  	Player 1 Win
Jonathan (chugs) Moore  	vs.	Sebastian Spicher  	Player 1 Win
Bryan Kong  	vs.	Anthony DT Zichella  	Player 2 Win
Connor Bryant  	vs.	Travis Woodward  	Player 2 Win
Brennan Tolnay  	vs.	Mariusz Suchanecki  	Player 1 Win
Anthony Cerenzio  	vs.	Chandler To  	Player 1 Win
Maciej Chmielewski  	vs.	Julian Sniffen  	Player 1 Win
Thomas Coleman  	vs.	Mae French  	Player 2 Win
Jonathan Richards  	vs.	Seth Penner  	Player 1 Win
Lucas Molho  	vs.	Leonardo Pessôa  	Player 2 Win
Zdeněk Matura  	vs.	Michael Lynch  	Player 2 Win
Michael Lau  	vs.	Eli Teed  	Player 1 Win
Daniel Rutkowski  	vs.	Jonathan Lemire  	Player 1 Win
Matthew VanPatten  	vs.	Justin Sybrandt  	Player 1 Win
Derek Copp  	vs.	Liam Trodden  	Player 2 Win
Sam OByrne  	vs.	Daniel Wolff  	Player 1 Win
Matt Garner  	vs.	Jeffery Fredrickson  	Player 1 Win
Damien Riggins  	vs.	Justin Liwag  	Player 1 Win
connor rooney  	vs.	Alexander Hempelmann  	Player 2 Win
Marvin Dominguez  	vs.	Justin Salmon  	Player 2 Win
Jesse Harper  	vs.	David Reitenbach  	Player 2 Win
Trenton McBride  	vs.	Nicholas Costanzo  	Player 2 Win
William Pearlman  	vs.	Aliasgar Dedanwala  	Player 2 Win
Kyle Eckenrode  	vs.	Frank Karamaroudis  	Player 2 Win
Michael Toryk  	vs.	Jacob Lantz  	Player 2 Win
Joel Repta  	vs.	Nathan Gardner  	Player 1 Win
Jeremiah Gardner  	vs.	Daniel Rothhaar  	Player 1 Win
Bun Ar  	vs.	Yuki Lee Bender  	Player 2 Win
Patrick Shaw  	vs.	Fabio Rego  	Player 2 Win
Shawn Adams  	vs.	Martin Schelasin  	Player 2 Win
Lee Kimball  	vs.	Shimon Bandiel  	Player 2 Win
Levi Rauch  	vs.	Todd Rowe  	Player 1 Win
Elijah Calub  	vs.	Ian Smith  	Player 2 Win
Dave Cordeiro  	vs.	Andrew Nguyen  	Player 2 Win
Roger Bodee  	vs.	Michael DeBoard  	Player 2 Win
Thomas Hood  	vs.	Isaac Rancic  	Player 2 Win
Chris Martin  	vs.	Aria How  	Player 1 Win
Patrick Yoder  	vs.	Adam Jessell  	Player 2 Win
Joel Grizzelle  	vs.	Tanya Wunder  	Player 1 Win
Davide Abis  	vs.	Rafaelo "Ruffy" Sarmiento  	Player 2 Win
Matthew Holinaty  	vs.	Gabe Sher  	Player 2 Win
The Better Johnson  	vs.	Fernando Caprino  	Player 2 Win
Bradley Tashman  	vs.	Madison Theriault  	Player 1 Win
ryan moran  	vs.	Ciro Gambone  	Player 1 Win
Zachry Benz  	vs.	Spencer Beck  	Player 1 Win
Matthew Cudney  	vs.	Ovas Siddiqui  	Player 1 Win
Nick Tucker  	vs.	Piotr Krzempek  	Player 2 Win
Sean Moyer  	vs.	Matt Davey  	Player 1 Win
Cole Pellatt  	vs.	Jodey Burney  	Player 1 Win
Steven Rodriguez  	vs.	Sean Davis  	Player 2 Win
nicklas starland  	vs.	Mathew Frye  	Player 1 Win
Thomas Briggs  	vs.	Justin Gottlieb  	Player 2 Win
Dennis Zhang  	vs.	Paul LE GOUEZ  	Player 2 Win
Benjamin Hebert  	vs.	Jackie Rousseau  	Player 1 Win
Ryan Thomas  	vs.	Andre Belote  	Player 1 Win
Corey Baker  	vs.	Robert Alonso  	Player 1 Win
Vlastimil Martinek Jr.  	vs.	Chenjun Liu  	Player 1 Win
Joshua Lau  	vs.	Steven Caraher  	Player 1 Win
Gregory Patellis  	vs.	Alex Sneed  	Player 1 Win
jamie bithell  	vs.	George Ferris  	Player 1 Win
Cooper Templeton  	vs.	Adrian Gebhart  	Player 1 Win
George Rodger  	vs.	Kevin Canales  	Player 1 Win
Bastien Le Guen  	vs.	Adrian Słowiński  	Player 2 Win
Wilson Badillo  	vs.	Branden Voss  	Player 1 Win
Aaron Grace  	vs.	Rob Sheridan  	Player 1 Win
Phillip Manwaring  	vs.	Dave Lin  	Player 2 Win
ry mo  	vs.	Erick Ortiz  	Player 2 Win
Nils Klaper  	vs.	Blake Godenzi  	Player 1 Win
John Romah  	vs.	Dmitry Sorokin  	Player 1 Win
Julian Felix Flury  	vs.	Sean Biava  	Draw
Ryan Wolohan  	vs.	Chris Brummett  	Player 2 Win
Mateusz Sass  	vs.	Chad Pennell  	Player 2 Win
Martin Hechtberger  	vs.	Jasiel Diez  	Player 1 Win
Andrew Goodwin  	vs.	Sabastian Chizhik  	Player 1 Win
Jonny Espejo  	vs.	Keith Milde  	Player 1 Win
Thorbjørn Lind Jensen  	vs.	Sean Fox  	Player 1 Win
Isaac Brooks  	vs.	Bill Jargowsky  	Player 1 Win
Alexander Benton  	vs.	Norman Bayliss  	Player 1 Win
Brandon Fields  	vs.	Haukur Thor Buason  	Player 2 Win
Jacob Clements  	vs.	David Letourneau  	Player 1 Win
Gary White  	vs.	Daniel Wolfe  	Draw
Derek Chiu  	vs.	Jonathan Walker  	Player 2 Win
Robbert Valkeneers  	vs.	Elijah Flanders  	Player 1 Win
Anastasia Benner  	vs.	RONNY MARTIN  	Player 2 Win
Matt Rogers  	vs.	Yuanji Li  	Player 1 Win
Erik Johnson  	vs.	Tonin ''Nini'' Veshi  	Player 2 Win
Tae Kim  	vs.	Devin Bell  	Player 2 Win
ANDREW WEBBER  	vs.	Carl Norman  	Player 1 Win
Thaminda Edirisooriya  	vs.	Anthony Herzog  	Player 1 Win
Randall Suliga  	vs.	Joseph Scalco  	Player 2 Win
Lorenzo Brambilla Pisoni  	vs.	David Lee  	Player 1 Win
Dexter Canright  	vs.	Eric Shoopman  	Player 1 Win
Jordan Self  	vs.	Andrew Bryant  	Player 2 Win
Timothy Wells  	vs.	Brandon Canedy  	Player 1 Win
Trent Lennon  	vs.	Caleb Womack  	Player 2 Win
Chris Ray  	vs.	Anthony Gascon  	Player 1 Win
Kyle Hebert  	vs.	Kenneth Justin  	Player 1 Win
Sebastian Russell  	vs.	Bobby Jarboe  	Player 1 Win
Kyle Richards  	vs.	John Wardan  	Player 1 Win
Matthew Halstad  	vs.	Kyle Thiele  	Player 2 Win
Joshua Himmelberger  	vs.	Douglas Levy  	Player 2 Win
Franche Tan  	vs.	Brandon Flores  	Player 1 Win
Zack Phillips  	vs.	Joshua Tavares  	Player 1 Win
Patrick Nelson  	vs.	Darren Black  	Player 1 Win
Skyler Lewis  	vs.	VINAY SONI  	Player 1 Win
Brandon Akers  	vs.	Jacob Hawkinson  	Player 2 Win
Camilo Herrera  	vs.	Sam Sutherland  	Player 2 Win
Luke Magnuson  	vs.	Donald Kell  	Player 2 Win
Andre Maldonado  	vs.	Logan Perry  	Player 2 Win
Aidan O'Sullivan  	vs.	Brian McLachlin  	Player 1 Win
Alexander Wolfe  	vs.	Andrew Blackwell  	Player 2 Win
Tyler Kerch  	vs.	Albert Schütt  	Player 2 Win
Logan Petersen  	vs.	Adrian Malana  	Player 2 Win
Porter Jones  	vs.	Tho Bui  	Player 2 Win
Alex Broussard  	vs.	Jake Landaiche  	Player 2 Win
Ian Olson  	vs.	Christopher Saldana  	Draw
Dyllon Dietz  	vs.	Kyle Shull  	Player 1 Win
Alex Tyler  	vs.	BRAD ALLRED  	Player 2 Win
Sage Husanu  	vs.	Tony Mapelli  	Player 2 Win
Derek Anderson  	vs.	Jasper Mork  	Player 2 Win
Ashley Yvette Bellevue  	vs.	Owen Young  	Player 2 Win
Nick Allen  	vs.	Tyler Kaminskie  	Player 1 Win
Tristan Hanson  	vs.	Brandon Green  	Player 1 Win
Aaron Guy  	vs.	Chris Rowland  	Player 1 Win
Evan Zumwalt  	vs.	Brandon Bianco  	Player 2 Win
Corey Waugh  	vs.	Bryce Kesterson  	Player 1 Win
Jose Santos martinez  	vs.	Michael Collins  	Player 2 Win
joseph lawson  	vs.	Thomas Jaszczur  	Player 1 Win
Chad Bortz  	vs.	Joshua Freeland  	Player 2 Win
Mitchell Tillery  	vs.	Gordon Koh Koh  	Player 2 Win
Parker Longwell  	vs.	Adam Weaver  	Player 2 Win
Grant Kern  	vs.	Dennis Pham  	Player 1 Win
Justin Rowland  	vs.	Justin Duszynski  	Player 1 Win
James Swain  	vs.	James Thourgood  	Player 2 Win
Ektor Angelomatis  	vs.	Lee Maring  	Player 2 Win
Michael Strianese  	vs.	Ethan Bridges  	Player 2 Win
Pascal Weiler  	vs.	Dexter Phan  	Player 2 Win
Tom Philippi  	vs.	Zach Dietz  	Player 2 Win
Nam Vo  	vs.	Bryce Johnson  	Player 1 Win
Michael Riddle  	vs.	Kevin Brayer  	Player 2 Win
Rylie Groff  	vs.	Haik Voskerchian  	Player 1 Win
Anthony Chiechi  	vs.	Jeerod Balangan  	Player 1 Win
Michael Ribar  	vs.	Vincent Gambone  	Player 1 Win
Shane Martin  	vs.	Taylor Nifong  	Player 1 Win
Christian Weißling  	vs.	Travis Reeder  	Player 1 Win
Stephen Perez  	vs.	Arkadiusz "Rasaad" Sioda  	Player 2 Win
John Zapata  	vs.	Tom Evans  	Player 2 Win
Shane Blake  	vs.	Robin Avenoso  	Player 2 Win
Ryan Levy  	vs.	Anthony Cicchinelli  	Player 2 Win
Joshua Korovesi  	vs.	Caleb Broussard  	Player 1 Win
Matt Muus  	vs.	Anderson Soares  	Player 1 Win
Amber Zee  	vs.	Matthew Puckett  	Player 2 Win
Michael McDowell  	vs.	Caleb Nelson  	Player 1 Win
Johnny Lam  	vs.	Spencer Fritts  	Player 1 Win
Marco Jurakovich  	vs.	BRENT ANDERSON  	Player 2 Win
Adam Green  	vs.	Hayley Neighbors  	Player 2 Win
Alex Brown  	vs.	Sasha Lang  	Player 1 Win
Tommy Hendricks  	vs.	Zach Allen  	Player 2 Win
Bryce Henschel  	vs.	Jonathan Wyatt  	Player 1 Win
Luke Shinn  	vs.	Daniel Collett  	Player 2 Win
Matthew Steeves  	vs.	Robert Postlewaite  	Player 2 Win
James Wray  	vs.	Cooper Pemelton  	Player 2 Win
Nicholas Santa  	vs.	Melissa Steinman  	Player 1 Win
Rocky Cremeans  	vs.	Ian Shaffer  	Player 2 Win
Daniel Warner  	vs.	Alexandre Lefebvre  	Player 1 Win
Shing Tsang  	vs.	Adam Roark  	Player 1 Win
Josef Mendez  	vs.	Sam (Real) Yuen  	Player 2 Win
Menion Croll  	vs.	Paul Fortin  	Player 2 Win
Jonathen Byrd  	vs.	William Bradshaw  	Player 1 Win
Steven Nemeth  	vs.	Matthew Terrell  	Player 2 Win
Charles Poe  	vs.	Kolbrun Palsdottir  	Player 2 Win
Jonas Benz  	vs.	William Bodo  	Player 1 Win
Matthew Verderame  	vs.	David Hopson  	Player 1 Win
Addison Hudson  	vs.	Gabriel Marengo  	Player 2 Win
Mason Taylor  	vs.	Nicholas Mejac  	Player 1 Win
westley nottingham  	vs.	Matthew Durci  	Player 2 Win
Adam Fronsee  	vs.	Will Pearce  	Player 1 Win
Max Small  	vs.	Robert Mills  	Player 1 Win
Ross Fontana  	vs.	TUCKER CAMPBELL  	Player 1 Win
Spencer Freeman  	vs.	JEREMY CHERNICK  	Player 1 Win
Carter Barton  	vs.	Noah Geiger  	Player 1 Win
Elliot Bicker  	vs.	Mike Morelli  	Player 1 Win
Jacob Balgoyen  	vs.	Tony DeCaro  	Player 1 Win
Edward Knight  	vs.	Mark Tan  	Player 1 Win
Matthew Fay  	vs.	Mitchell Blowey  	Player 1 Win
Justin Cardoza  	vs.	Colin Ross  	Player 2 Win
Chad Wischnewsky  	vs.	Ricky Perez  	Player 2 Win
Jesus Garcia Gomez-Valades  	vs.	Jacob Kurka  	Player 1 Win
Kyler Dustin  	vs.	Tristan Mitchell  	Player 2 Win
Justin Hill  	vs.	Nick Bova  	Player 2 Win
Nathaniel Meserve  	vs.	Cory Lonas  	Player 1 Win
Charles Simmons  	vs.	Connor Matza  	Player 2 Win
anthony Petrillo  	vs.	Tim Seib  	Player 1 Win
Dayna Hagewood  	vs.	Rowsendo Nelson  	Player 2 Win
Jonah Overholt  	vs.	Keegan Wolohan  	Player 1 Win
Philippe Paquin  	vs.	Jonas Stoberock  	Player 2 Win
Carson Osborne  	vs.	Luis Maderas  	Player 2 Win
Bryan Knecht  	vs.	Christopher Yunck  	Player 2 Win
JUSTIN FRYAR  	vs.	Kyle Meserve  	Player 2 Win
Adam Tran  	vs.	Jakub "Lemur" Siedlecki  	Player 1 Win
Paulo Fernandes  	vs.	Brett Merold  	Player 2 Win
Alec Myers  	vs.	AARON COLHOUER  	Player 1 Win
Joshua Rath  	vs.	Aidan Arruza  	Player 2 Win
Nathan Crawford  	vs.	Jamie Utley  	Player 1 Win
Alex Slotnick  	vs.	Andrew Melson  	Player 1 Win
David Brannen  	vs.	Philip Middleton  	Player 2 Win
Christopher Dietz  	vs.	Blake Lococo  	Player 2 Win
Andrew Wachter  	vs.	Daniel Bellotti  	Player 1 Win
Austin Tippen  	vs.	Michael Rutkowski  	Player 2 Win
James Warburton  	vs.	Nicholas Hoover  	Player 1 Win
Mateusz Jasiński  	vs.	Kent Summerour  	Player 1 Win
Scott Egan  	vs.	Kevin Set  	Player 1 Win
Chris Legg  	vs.	Marcus Brown  	Player 1 Win
William Euson  	vs.	Greg Mitchell  	Player 2 Win
Justin Balanca-Hawkes  	vs.	Jordan Biggs  	Draw
Joseph Bowers  	vs.	Eric Holmes  	Player 2 Win
Joshua Paris  	vs.	Nicholas Snyder  	Player 1 Win
Hendrik Wytze Kluitenberg  	vs.	Thomas Mottram  	Player 2 Win
Ben Sharrin  	vs.	Pierre-Nicolas Perrin  	Player 1 Win
Justin Addington  	vs.	Bruno Cracco  	Player 2 Win
Erika Forslöf  	vs.	Jonathan Seaborn  	Player 2 Win
Christian Ugaban  	vs.	Artie Hamelin  	Player 2 Win
Ryan Barnett  	vs.	Wyatt Goehring  	Player 1 Win
Matt Smith  	vs.	Eric Dauernnheim  	Player 2 Win
Kyle Gant  	vs.	Erick Boeder  	Player 2 Win
William Pate  	vs.	James Smith  	Draw
Guillem Las Heras Aixandri  	vs.	Case Johnson  	Player 1 Win
Joshua Levy  	vs.	Bartosz Dominiak  	Player 2 Win
Ethan Mitchell  	vs.	Michael Tucci  	Player 1 Win
Gregory Price  	vs.	Sara Smith  	Player 1 Win
Jenna Schoettker  	vs.	Lexie Klasing  	Player 2 Win
Jeremy Scruggs  	vs.	Michael Dorsey  	Player 1 Win
Brandon Bowden  	vs.	Riley Lont  	Player 2 Win
Michael Bell  	vs.	Hollis Eacho  	Player 1 Win
Quinn Wongkew  	vs.	Pete Stalker  	Player 1 Win
Tyler Meacher  	vs.	Lee Conner  	Player 2 Win
Mike DeNicola  	vs.	Nicholas Trotta  	Player 1 Win
Ben Cook  	vs.	Tessa Myers  	Player 2 Win
Jordan Brengartner  	vs.	Nicholas Brown  	Player 1 Win
Michael Pawlak  	vs.	Kyle Peterson  	Player 1 Win
Katie Koslosky  	vs.	Matt Jacobs  	Player 2 Win
Natalie Hunt  	vs.	Caleb Zavits  	Player 2 Win
Tyler Wolford  	vs.	Ryan AuCoin  	Player 1 Win
Walter Snowden  	vs.	Tommy Golightly  	Player 2 Win
Adhy Kumar  	vs.	Dakota Scales  	Player 2 Win
Leo Shea  	vs.	Andrew Mellina  	Player 1 Win
Cameron Boutot  	vs.	Alberto Ruiz  	Player 1 Win
John Powell  	vs.	Conner Holtgreive  	Player 1 Win
Ravi Nehra  	vs.	Holden Isaacs  	Player 2 Win
Lindsey Thiele  	vs.	Justin Matlack  	Player 2 Win
Will Reinhardt  	vs.	Gerald Camangon  	Player 2 Win
Jesus Montijo  	vs.	Felipe Costa Batista  	Player 2 Win
Alexander Karlson  	vs.	Skyler Cady  	Player 2 Win
Gabriel Rasicot  	vs.	Zackary Whitt  	Player 2 Win
Shaheen Soorani  	vs.	Devon Conn  	Double Loss
Samuel Ham  	vs.	Nigel Wunder  	Player 1 Win
Jeffrey Lang  	vs.	Eric Gorski  	Player 2 Win
Chase Reiser  	vs.	Nicolas Bouffard  	Player 2 Win
Jesse Machusak  	vs.	Tatiana Parada  	Player 1 Win
Mike Euson  	vs.	Chad McKittrick  	Player 1 Win
Kevin Fontan  	vs.	Michael Fay  	Player 2 Win
Brandon Datwyler  	vs.	Ethan Kirychuk  	Player 2 Win
Logan Brushart  	vs.	Lucas Codato Antonio Silva  	Player 2 Win
James Cæruleus Silver  	vs.	Will Rea  	Player 2 Win
Christian Gerdes  	vs.	Brandan St. Amour  	Player 1 Win
Chad Allred  	vs.	Brandon Crawford  	Player 2 Win
Aidan Kwasneski  	vs.	Michael McDermott  	Player 1 Win
Paul Deegan  	vs.	David Sitrick  	Player 2 Win
Daniel Smock  	vs.	Colton Miller  	Player 2 Win
Jeff Okrasinski  	vs.	Donovan Wilcox  	Player 2 Win
Alex Yun  	vs.	Erick Lofton  	Player 2 Win
Jonathan Julian  	vs.	Alan Chavarin  	Player 1 Win
Jason Irons  	vs.	Zoey Gerstner  	Player 2 Win
George Panageotou  	vs.	Kevin Guinn  	Player 2 Win
Emanuel Camacho  	vs.	Daniel Davila  	Player 2 Win
Ryan Nenninger  	vs.	James Tague  	Player 1 Win
June Aino  	vs.	Abbas Dedanwala  	Player 2 Win
Andrew Lundeen  	vs.	Daniel Link  	Player 1 Win
Allison Oram  	vs.	Airton dos Santos Junior  	Player 2 Win
Catherine Powell  	vs.	Jordan Blankenship  	Player 1 Win
Matt Mills  	vs.	Manuel Rosario  	Player 1 Win
Alexander Choiniere  	vs.	Alek Idol  	Draw
Michael Popowich  	vs.	Darius Hambleton  	Player 1 Win
Connor Talty  	vs.	Joseph Cicchini  	Player 1 Win
Zachary Sweigart  	vs.	Michael Cusick  	Player 2 Win
Jesse Shaw  	vs.	Gwyndolin Newbill  	Player 1 Win
Josh Campos  	vs.	Chris Kern  	Player 2 Win
Andrew MacNamee  	vs.	Walker Stephens  	Player 2 Win
Zachary Campos  	vs.	Kashiem Brown  	Player 2 Win
Jared Wyce  	vs.	Shawn Sapiel  	Player 1 Win
Russell Hedlund  	vs.	Mara Richard  	Player 1 Win
Justin Harris  	vs.	Ashley Babiarz  	Player 1 Win
James Prince  	vs.	None	Player 1 Win
#####
Darryl Thompson  	vs.	Tee Thebeau  	Player 2 Win
Lucas Bannigan  	vs.	Jack Stoney  	Player 2 Win
James Adams  	vs.	Marcelo Gazzaneo  	Player 2 Win
Philip Parker  	vs.	Jeremy Langevin  	Player 2 Win
Andrew Henderson  	vs.	Jonathan Magnuson  	Player 2 Win
Matthew W  	vs.	John Colvin  	Player 1 Win
Donovan van Beek  	vs.	Jeff Thompson  	Player 2 Win
Emery Powell  	vs.	Matt MacLeod  	Player 2 Win
Taylor Crawford  	vs.	Colin Swisher  	Player 1 Win
Jacob Kissel  	vs.	DYLAN MANGINI  	Player 1 Win
Max Dieckmann  	vs.	Daniel Correas  	Player 2 Win
Oliver Phi  	vs.	Yan Garito  	Player 1 Win
nicolas Jamoulle  	vs.	Dylan Ashcraft  	Player 1 Win
Jie ma  	vs.	Chris Brummett  	Player 1 Win
Joshua Lovell  	vs.	Chris Fazio  	Player 1 Win
Raj Parikh  	vs.	RONNY MARTIN  	Player 1 Win
Timothy Scroggs  	vs.	Cooper Templeton  	Player 1 Win
Merrick Kemp  	vs.	Andrew Nguyen  	Player 2 Win
Ian Daryl Bon  	vs.	Damien Riggins  	Player 2 Win
Tyler Brotton  	vs.	George Rodger  	Player 1 Win
Chuck Hutchins  	vs.	Philip van Donselaar  	Player 2 Win
Tanner Propst  	vs.	Louis Solymos  	Player 2 Win
Dylan Myers  	vs.	Matt Rogers  	Player 2 Win
Dan Mui  	vs.	Matt Garner  	Player 1 Win
Paul White  	vs.	Peyton Sayasith  	Player 1 Win
Randall Sims  	vs.	Dave Lin  	Player 2 Win
Alex Ptak  	vs.	Jacob Lantz  	Player 2 Win
Paul Naughton  	vs.	Martin Schelasin  	Player 1 Win
Ren Fisk  	vs.	Jonny Espejo  	Player 2 Win
Eric Cortez omana  	vs.	Dylan Williamson  	Player 2 Win
Daniel Ferrara  	vs.	Austin Kim  	Player 2 Win
David Trinh  	vs.	Ian Smith  	Player 1 Win
Jake Wenger  	vs.	Jacob Baugh  	Player 2 Win
Ryan Garris  	vs.	Samuel Hershey  	Player 1 Win
Clay DeAngelis  	vs.	Vlastimil Martinek Jr.  	Player 2 Win
Nathanael Hunt  	vs.	Daniel Rutkowski  	Player 2 Win
Nicholas Porter  	vs.	Jonathan (chugs) Moore  	Player 1 Win
Sam OByrne  	vs.	Corey Baker  	Player 2 Win
Zach Bunn  	vs.	Adrian Słowiński  	Player 1 Win
Anthony Cerenzio  	vs.	Aaron Grace  	Player 2 Win
Brennan Tolnay  	vs.	Joel Repta  	Player 1 Win
Jonathan Richards  	vs.	John Romah  	Player 1 Win
Maciej Chmielewski  	vs.	ryan moran  	Player 1 Win
Matthew VanPatten  	vs.	Piotr Krzempek  	Player 2 Win
Michael Lau  	vs.	Dexter Canright  	Player 1 Win
Timothy Long  	vs.	Erick Ortiz  	Player 1 Win
Jeremiah Gardner  	vs.	Devin Bell  	Player 1 Win
Joel Grizzelle  	vs.	jamie bithell  	Player 2 Win
Frank Karamaroudis  	vs.	Levi Rauch  	Player 2 Win
Chris Martin  	vs.	Zachry Benz  	Player 2 Win
Sean Moyer  	vs.	Caleb Womack  	Player 2 Win
Bradley Tashman  	vs.	Michael Lynch  	Player 1 Win
Leonardo Pessôa  	vs.	Justin Gottlieb  	Player 2 Win
Matthew Cudney  	vs.	Chris Ray  	Player 2 Win
Fernando Caprino  	vs.	nicklas starland  	Player 1 Win
Fabio Rego  	vs.	Timothy Wells  	Player 2 Win
Cole Pellatt  	vs.	Gregory Patellis  	Player 2 Win
Benjamin Hebert  	vs.	Ryan Thomas  	Player 1 Win
Gabe Sher  	vs.	Nils Klaper  	Player 1 Win
Joshua Lau  	vs.	Anthony DT Zichella  	Player 2 Win
Nicholas Costanzo  	vs.	Haukur Thor Buason  	Player 2 Win
Adam Jessell  	vs.	Travis Woodward  	Player 1 Win
Wilson Badillo  	vs.	Andrew Goodwin  	Player 2 Win
Sean Davis  	vs.	David Reitenbach  	Player 2 Win
Yuki Lee Bender  	vs.	Thorbjørn Lind Jensen  	Player 1 Win
Alexander Benton  	vs.	Paul LE GOUEZ  	Player 1 Win
Martin Hechtberger  	vs.	Shimon Bandiel  	Player 1 Win
Chad Pennell  	vs.	Rafaelo "Ruffy" Sarmiento  	Player 2 Win
Isaac Rancic  	vs.	Jonathan Walker  	Player 1 Win
Jacob Clements  	vs.	Isaac Brooks  	Player 1 Win
Aliasgar Dedanwala  	vs.	Andrew Bryant  	Player 2 Win
Robbert Valkeneers  	vs.	ANDREW WEBBER  	Player 2 Win
Liam Trodden  	vs.	Tonin ''Nini'' Veshi  	Player 1 Win
Michael DeBoard  	vs.	Lorenzo Brambilla Pisoni  	Player 1 Win
Thaminda Edirisooriya  	vs.	Mae French  	Player 1 Win
Justin Salmon  	vs.	Alexander Hempelmann  	Player 1 Win
Joshua Kehe  	vs.	Skyler Lewis  	Player 1 Win
Lucas Molho  	vs.	Kyle Eckenrode  	Player 1 Win
Derek Copp  	vs.	Phillip Manwaring  	Player 1 Win
Bryan Kong  	vs.	Gary White  	Player 1 Win
Thomas Coleman  	vs.	Roger Bodee  	Player 2 Win
Eli Teed  	vs.	Kevin Brayer  	Player 1 Win
Connor Bryant  	vs.	connor rooney  	Player 2 Win
Zdeněk Matura  	vs.	Mason Taylor  	Player 1 Win
William Pearlman  	vs.	Sabastian Chizhik  	Player 1 Win
Marvin Dominguez  	vs.	Tae Kim  	Player 2 Win
Seth Penner  	vs.	Adam Tran  	Player 2 Win
Trenton McBride  	vs.	Davide Abis  	Player 2 Win
Patrick Shaw  	vs.	Robert Postlewaite  	Player 1 Win
Michael Toryk  	vs.	Madison Theriault  	Player 1 Win
Jesse Harper  	vs.	Sean Biava  	Player 1 Win
Bun Ar  	vs.	Eric Holmes  	Player 1 Win
Dave Cordeiro  	vs.	Matthew Holinaty  	Player 1 Win
Shawn Adams  	vs.	Chandler To  	Player 2 Win
Lee Kimball  	vs.	Elliot Bicker  	Player 1 Win
Elijah Calub  	vs.	Edward Knight  	Player 2 Win
Thomas Hood  	vs.	Tom Evans  	Player 2 Win
Daniel Wolff  	vs.	Bartosz Dominiak  	Player 2 Win
Mariusz Suchanecki  	vs.	Lee Maring  	Player 2 Win
Patrick Yoder  	vs.	Cooper Pemelton  	Player 2 Win
Julian Felix Flury  	vs.	Sebastian Spicher  	Player 1 Win
The Better Johnson  	vs.	Michael Ribar  	Player 1 Win
Julian Sniffen  	vs.	Jeffery Fredrickson  	Player 1 Win
Spencer Beck  	vs.	Nick Bova  	Player 2 Win
Todd Rowe  	vs.	Patrick Nelson  	Player 1 Win
Nick Tucker  	vs.	Douglas Levy  	Player 1 Win
Aiden Dee  	vs.	Ethan Bridges  	Player 2 Win
Kevin Tran  	vs.	Branden Voss  	Player 2 Win
Thomas Briggs  	vs.	Elijah Flanders  	Player 2 Win
Mathew Frye  	vs.	Kyle Hebert  	Player 1 Win
Jodey Burney  	vs.	Adrian Gebhart  	Player 1 Win
Alex Sneed  	vs.	Eric Dauernnheim  	Player 2 Win
Dennis Zhang  	vs.	Spencer Freeman  	Player 2 Win
Steven Rodriguez  	vs.	Steven Caraher  	Player 1 Win
Dmitry Sorokin  	vs.	Tristan Hanson  	Player 2 Win
Ovas Siddiqui  	vs.	Aidan O'Sullivan  	Player 2 Win
Bastien Le Guen  	vs.	Daniel Warner  	Player 1 Win
ry mo  	vs.	Chenjun Liu  	Player 2 Win
Ryan Wolohan  	vs.	Ian Shaffer  	Player 2 Win
Mateusz Sass  	vs.	Michael Collins  	Player 1 Win
Aria How  	vs.	Matthew Verderame  	Player 1 Win
Ciro Gambone  	vs.	Yuanji Li  	Player 2 Win
Anastasia Benner  	vs.	Carl Norman  	Player 2 Win
Brandon Fields  	vs.	Rylie Groff  	Player 2 Win
Bill Jargowsky  	vs.	Jonas Stoberock  	Player 2 Win
Norman Bayliss  	vs.	Dexter Phan  	Player 2 Win
Daniel Rothhaar  	vs.	Alec Myers  	Player 1 Win
David Letourneau  	vs.	Colin Ross  	Player 1 Win
George Ferris  	vs.	Michael McDowell  	Player 1 Win
Majin Bae  	vs.	Joshua Freeland  	Player 1 Win
Keith Milde  	vs.	Franche Tan  	Player 2 Win
Derek Chiu  	vs.	Daniel Collett  	Player 2 Win
Robert Alonso  	vs.	Kyle Meserve  	Player 2 Win
Jasiel Diez  	vs.	Logan Perry  	Player 1 Win
Erik Johnson  	vs.	Justin Rowland  	Player 2 Win
Kevin Canales  	vs.	Hayley Neighbors  	Player 1 Win
Joseph Scalco  	vs.	Kyle Thiele  	Player 2 Win
Randall Suliga  	vs.	Adrian Malana  	Player 1 Win
Daniel Wolfe  	vs.	Michael Rutkowski  	Player 2 Win
Jonathan Lemire  	vs.	Nam Vo  	Player 1 Win
Anthony Herzog  	vs.	Jesus Garcia Gomez-Valades  	Player 2 Win
Nathan Gardner  	vs.	Bryce Henschel  	Player 2 Win
Jackie Rousseau  	vs.	Sebastian Russell  	Draw
Fuzzy Delp  	vs.	James Thourgood  	Player 1 Win
Rob Sheridan  	vs.	Paul Fortin  	Player 1 Win
David Lee  	vs.	Eric Shoopman  	Player 1 Win
Justin Liwag  	vs.	Joshua Paris  	Player 1 Win
Jordan Self  	vs.	Jonathen Byrd  	Player 2 Win
Trent Lennon  	vs.	Bruno Cracco  	Player 1 Win
Aidan Berkel  	vs.	Nick Allen  	Player 1 Win
Sean Fox  	vs.	Tony Mapelli  	Player 2 Win
Blake Godenzi  	vs.	Donald Kell  	Player 2 Win
Justin Sybrandt  	vs.	Andre Belote  	Player 1 Win
Tanya Wunder  	vs.	Connor Matza  	Player 1 Win
Brandon Canedy  	vs.	BRAD ALLRED  	Player 1 Win
Kyle Richards  	vs.	Brandon Bianco  	Player 2 Win
Zack Phillips  	vs.	BRENT ANDERSON  	Draw
Dyllon Dietz  	vs.	Ethan Mitchell  	Player 1 Win
Aaron Guy  	vs.	Scott Egan  	Player 2 Win
joseph lawson  	vs.	Andrew Blackwell  	Player 2 Win
Grant Kern  	vs.	Tho Bui  	Player 1 Win
Corey Waugh  	vs.	Erick Boeder  	Player 1 Win
Gordon Koh Koh  	vs.	Jonah Overholt  	Player 1 Win
Anthony Chiechi  	vs.	Jake Landaiche  	Player 1 Win
Shane Martin  	vs.	Zach Allen  	Player 2 Win
Albert Schütt  	vs.	Greg Mitchell  	Player 2 Win
Christian Weißling  	vs.	Matthew Durci  	Player 1 Win
Arkadiusz "Rasaad" Sioda  	vs.	Zach Dietz  	Player 1 Win
Joshua Korovesi  	vs.	Nathaniel Meserve  	Player 2 Win
Johnny Lam  	vs.	Jasper Mork  	Player 1 Win
Owen Young  	vs.	Gregory Price  	Player 1 Win
Matt Muus  	vs.	Ben Sharrin  	Player 1 Win
Nicholas Santa  	vs.	Max Small  	Player 1 Win
Shing Tsang  	vs.	Gabriel Marengo  	Player 2 Win
Jonas Benz  	vs.	Sam Sutherland  	Player 2 Win
Alex Brown  	vs.	Adam Fronsee  	Player 1 Win
Matthew Puckett  	vs.	Jonathan Seaborn  	Player 1 Win
Matthew Terrell  	vs.	Ricky Perez  	Player 1 Win
Ross Fontana  	vs.	Tristan Mitchell  	Player 1 Win
Carter Barton  	vs.	Matthew Fay  	Player 2 Win
Robin Avenoso  	vs.	Artie Hamelin  	Player 1 Win
Jacob Balgoyen  	vs.	Rowsendo Nelson  	Draw
Jacob Hawkinson  	vs.	Ryan Barnett  	Player 2 Win
anthony Petrillo  	vs.	Nathan Crawford  	Player 2 Win
Christopher Yunck  	vs.	Kolbrun Palsdottir  	Player 1 Win
Alex Slotnick  	vs.	Andrew Wachter  	Player 1 Win
Philip Middleton  	vs.	Brett Merold  	Player 2 Win
Mateusz Jasiński  	vs.	James Warburton  	Player 1 Win
Chris Legg  	vs.	Anthony Cicchinelli  	Player 2 Win
Aidan Arruza  	vs.	Luis Maderas  	Player 2 Win
Blake Lococo  	vs.	Thomas Mottram  	Player 1 Win
Guillem Las Heras Aixandri  	vs.	Sam (Real) Yuen  	Player 1 Win
Ian Olson  	vs.	Aidan Kwasneski  	Player 1 Win
Matthew Halstad  	vs.	Camilo Herrera  	Player 1 Win
Alexander Wolfe  	vs.	Paulo Fernandes  	Player 2 Win
Tyler Kerch  	vs.	Menion Croll  	Player 2 Win
Luke Magnuson  	vs.	David Sitrick  	Player 1 Win
Alex Broussard  	vs.	Michael Riddle  	Player 1 Win
Derek Anderson  	vs.	Ryan Nenninger  	Player 1 Win
Andre Maldonado  	vs.	Andrew Melson  	Player 2 Win
Logan Petersen  	vs.	Colton Miller  	Player 2 Win
Kenneth Justin  	vs.	Brandon Akers  	Player 2 Win
Sage Husanu  	vs.	Jesse Machusak  	Player 2 Win
Bobby Jarboe  	vs.	Tommy Golightly  	Player 1 Win
Brian McLachlin  	vs.	Quinn Wongkew  	Player 1 Win
Jose Santos martinez  	vs.	Travis Reeder  	Player 2 Win
Ektor Angelomatis  	vs.	Brandon Green  	Player 2 Win
Parker Longwell  	vs.	Matt Jacobs  	Player 2 Win
Joshua Tavares  	vs.	Marcus Brown  	Player 2 Win
Michael Strianese  	vs.	Justin Matlack  	Player 2 Win
Christopher Saldana  	vs.	Zackary Whitt  	Player 2 Win
Jeerod Balangan  	vs.	Luke Shinn  	Player 2 Win
John Zapata  	vs.	Hendrik Wytze Kluitenberg  	Player 1 Win
Shane Blake  	vs.	Sasha Lang  	Player 2 Win
Stephen Perez  	vs.	Marco Jurakovich  	Player 2 Win
Ryan Levy  	vs.	Sara Smith  	Player 1 Win
Adam Green  	vs.	Gerald Camangon  	Player 1 Win
Amber Zee  	vs.	Kent Summerour  	Player 2 Win
Josef Mendez  	vs.	John Powell  	Player 1 Win
westley nottingham  	vs.	Abbas Dedanwala  	Player 2 Win
Rocky Cremeans  	vs.	Michael Fay  	Player 2 Win
Steven Nemeth  	vs.	Dakota Scales  	Player 1 Win
Charles Poe  	vs.	Dayna Hagewood  	Player 2 Win
Addison Hudson  	vs.	Donovan Wilcox  	Player 2 Win
Mark Tan  	vs.	Jesse Shaw  	Player 1 Win
Brandon Flores  	vs.	Caleb Broussard  	Player 2 Win
Mitchell Blowey  	vs.	Christian Ugaban  	Double Loss
Justin Cardoza  	vs.	Jakub "Lemur" Siedlecki  	Player 2 Win
Tony DeCaro  	vs.	Adam Roark  	Player 2 Win
Nicholas Mejac  	vs.	Mike DeNicola  	Player 1 Win
Charles Simmons  	vs.	Michael Popowich  	Player 2 Win
Justin Hill  	vs.	Melissa Steinman  	Player 1 Win
Kyler Dustin  	vs.	Taylor Nifong  	Player 1 Win
Chad Wischnewsky  	vs.	Bryce Johnson  	Player 2 Win
William Bradshaw  	vs.	Mike Morelli  	Player 1 Win
Justin Balanca-Hawkes  	vs.	Matt Mills  	Player 1 Win
Bryan Knecht  	vs.	Catherine Powell  	Player 1 Win
Keegan Wolohan  	vs.	Kevin Set  	Player 2 Win
Daniel Bellotti  	vs.	Tyler Wolford  	Player 2 Win
Robert Mills  	vs.	Jonathan Julian  	Player 2 Win
Tim Seib  	vs.	William Euson  	Player 1 Win
Joshua Rath  	vs.	Christian Gerdes  	Player 2 Win
TUCKER CAMPBELL  	vs.	Michael Cusick  	Player 1 Win
Joseph Bowers  	vs.	Ethan Kirychuk  	Player 2 Win
David Brannen  	vs.	Chris Kern  	Player 1 Win
Haik Voskerchian  	vs.	Andrew Lundeen  	Player 1 Win
Jordan Biggs  	vs.	James Smith  	Player 2 Win
Nicholas Snyder  	vs.	Lexie Klasing  	Player 1 Win
Kyle Shull  	vs.	Justin Addington  	Player 1 Win
Erika Forslöf  	vs.	William Bodo  	Player 1 Win
Tyler Kaminskie  	vs.	Cory Lonas  	Double Loss
Matt Smith  	vs.	Airton dos Santos Junior  	Player 2 Win
Pierre-Nicolas Perrin  	vs.	Brandon Crawford  	Player 2 Win
Bryce Kesterson  	vs.	Skyler Cady  	Player 1 Win
William Pate  	vs.	Dennis Pham  	Player 1 Win
Case Johnson  	vs.	Lee Conner  	Player 2 Win
Joshua Levy  	vs.	Michael Tucci  	Player 1 Win
Chris Rowland  	vs.	Will Rea  	Player 1 Win
Nicholas Hoover  	vs.	Kevin Guinn  	Player 1 Win
Caleb Nelson  	vs.	Daniel Davila  	Player 2 Win
Jeremy Scruggs  	vs.	Holden Isaacs  	Player 2 Win
Michael Bell  	vs.	Caleb Zavits  	Player 1 Win
Jordan Brengartner  	vs.	Michael Pawlak  	Player 1 Win
Leo Shea  	vs.	Mike Euson  	Player 1 Win
Felipe Costa Batista  	vs.	Eric Gorski  	Player 1 Win
Erick Lofton  	vs.	Zoey Gerstner  	Player 2 Win
Connor Talty  	vs.	Lucas Codato Antonio Silva  	Player 1 Win
Brandon Bowden  	vs.	Adhy Kumar  	Player 1 Win
Katie Koslosky  	vs.	Daniel Smock  	Player 1 Win
Walter Snowden  	vs.	Jeff Okrasinski  	Player 2 Win
Lindsey Thiele  	vs.	Nigel Wunder  	Player 2 Win
Gabriel Rasicot  	vs.	Chad Allred  	Player 2 Win
Alexander Karlson  	vs.	Pete Stalker  	Player 1 Win
Jeffrey Lang  	vs.	Russell Hedlund  	Player 1 Win
Chase Reiser  	vs.	Michael McDermott  	Player 2 Win
Logan Brushart  	vs.	Daniel Link  	Player 2 Win
Chad McKittrick  	vs.	Walker Stephens  	Draw
Brandon Datwyler  	vs.	Alexander Choiniere  	Player 1 Win
Nicholas Trotta  	vs.	Andrew Mellina  	Player 1 Win
Alex Yun  	vs.	James Prince  	Player 2 Win
Brandan St. Amour  	vs.	Kyle Peterson  	Player 2 Win
Allison Oram  	vs.	Nicholas Brown  	Player 1 Win
James Tague  	vs.	Tatiana Parada  	Player 1 Win
Alek Idol  	vs.	Kashiem Brown  	Player 1 Win
Zachary Sweigart  	vs.	Jared Wyce  	Player 2 Win
Manuel Rosario  	vs.	Justin Harris  	Player 1 Win
Andrew MacNamee  	vs.	Ashley Babiarz  	Player 2 Win
#####
Matthew W  	vs.	Jonathan Magnuson  	Player 1 Win
Taylor Crawford  	vs.	Tee Thebeau  	Player 2 Win
Jeremy Langevin  	vs.	Jeff Thompson  	Player 1 Win
Jacob Kissel  	vs.	Jack Stoney  	Player 1 Win
Marcelo Gazzaneo  	vs.	nicolas Jamoulle  	Player 2 Win
Daniel Correas  	vs.	Matt MacLeod  	Player 1 Win
Oliver Phi  	vs.	Andrew Bryant  	Player 1 Win
Darryl Thompson  	vs.	David Reitenbach  	Player 2 Win
James Adams  	vs.	John Colvin  	Player 2 Win
Philip Parker  	vs.	Donovan van Beek  	Player 2 Win
Lucas Bannigan  	vs.	Philip van Donselaar  	Player 1 Win
Andrew Henderson  	vs.	Justin Salmon  	Player 2 Win
Max Dieckmann  	vs.	Caleb Womack  	Player 1 Win
Emery Powell  	vs.	Martin Hechtberger  	Player 1 Win
DYLAN MANGINI  	vs.	Dave Lin  	Player 2 Win
Colin Swisher  	vs.	Yuki Lee Bender  	Player 1 Win
Yan Garito  	vs.	Austin Kim  	Player 2 Win
Dylan Ashcraft  	vs.	Raj Parikh  	Player 1 Win
Joshua Lovell  	vs.	Piotr Krzempek  	Player 2 Win
Louis Solymos  	vs.	Fernando Caprino  	Player 2 Win
Tyler Brotton  	vs.	ANDREW WEBBER  	Player 1 Win
Jie ma  	vs.	David Trinh  	Player 2 Win
Timothy Scroggs  	vs.	Jacob Clements  	Player 2 Win
Paul White  	vs.	Paul Naughton  	Player 2 Win
Dan Mui  	vs.	Zachry Benz  	Player 1 Win
Jacob Baugh  	vs.	Zach Bunn  	Player 2 Win
Dylan Williamson  	vs.	Andrew Goodwin  	Player 2 Win
Nicholas Porter  	vs.	Andrew Nguyen  	Player 2 Win
Jacob Lantz  	vs.	Timothy Long  	Player 2 Win
Maciej Chmielewski  	vs.	Haukur Thor Buason  	Player 1 Win
Brennan Tolnay  	vs.	Michael DeBoard  	Player 1 Win
Jonathan Richards  	vs.	Adam Jessell  	Player 2 Win
Damien Riggins  	vs.	Daniel Rutkowski  	Player 2 Win
Michael Lau  	vs.	Gabe Sher  	Player 2 Win
Jeremiah Gardner  	vs.	Levi Rauch  	Player 2 Win
Bradley Tashman  	vs.	Corey Baker  	Player 1 Win
jamie bithell  	vs.	Benjamin Hebert  	Player 2 Win
Justin Gottlieb  	vs.	Matt Rogers  	Player 2 Win
Vlastimil Martinek Jr.  	vs.	Gregory Patellis  	Player 2 Win
Aaron Grace  	vs.	Rafaelo "Ruffy" Sarmiento  	Player 1 Win
Alexander Benton  	vs.	Jonny Espejo  	Player 1 Win
Isaac Rancic  	vs.	Liam Trodden  	Player 1 Win
Thaminda Edirisooriya  	vs.	Timothy Wells  	Player 2 Win
Anthony DT Zichella  	vs.	Chris Ray  	Player 1 Win
Merrick Kemp  	vs.	Jonathan Walker  	Player 1 Win
Ian Daryl Bon  	vs.	Jake Wenger  	Player 2 Win
Chuck Hutchins  	vs.	Majin Bae  	Player 2 Win
Peyton Sayasith  	vs.	Anthony Cicchinelli  	Player 1 Win
Tanner Propst  	vs.	Aliasgar Dedanwala  	Player 1 Win
Eric Cortez omana  	vs.	Mae French  	Player 1 Win
Dylan Myers  	vs.	Bryce Henschel  	Player 1 Win
Alex Ptak  	vs.	Spencer Freeman  	Player 1 Win
Ren Fisk  	vs.	Gabriel Marengo  	Player 1 Win
Daniel Ferrara  	vs.	Nicholas Santa  	Player 2 Win
Randall Sims  	vs.	Matthew Fay  	Player 1 Win
Samuel Hershey  	vs.	Clay DeAngelis  	Player 2 Win
Anthony Cerenzio  	vs.	Zdeněk Matura  	Player 1 Win
Nathanael Hunt  	vs.	Kyle Thiele  	Player 1 Win
Matthew VanPatten  	vs.	Leonardo Pessôa  	Player 1 Win
Matt Garner  	vs.	Brett Merold  	Player 1 Win
Sam OByrne  	vs.	Aidan Berkel  	Player 2 Win
Jonathan (chugs) Moore  	vs.	Ross Fontana  	Player 1 Win
Chris Fazio  	vs.	Ryan Barnett  	Player 2 Win
Joel Repta  	vs.	Mateusz Jasiński  	Player 2 Win
Joel Grizzelle  	vs.	Bun Ar  	Player 2 Win
Frank Karamaroudis  	vs.	Adrian Słowiński  	Player 2 Win
Chris Martin  	vs.	Thorbjørn Lind Jensen  	Player 2 Win
ryan moran  	vs.	Trent Lennon  	Player 1 Win
Sean Moyer  	vs.	Michael Rutkowski  	Player 1 Win
Cole Pellatt  	vs.	Tony Mapelli  	Player 1 Win
Fabio Rego  	vs.	Johnny Lam  	Player 2 Win
Michael Lynch  	vs.	Ryan Thomas  	Player 1 Win
nicklas starland  	vs.	Lee Maring  	Player 1 Win
Matthew Cudney  	vs.	Edward Knight  	Player 2 Win
George Rodger  	vs.	Christian Weißling  	Player 1 Win
Martin Schelasin  	vs.	Nathan Crawford  	Player 2 Win
Joshua Lau  	vs.	Alex Slotnick  	Player 1 Win
Nicholas Costanzo  	vs.	Isaac Brooks  	Player 2 Win
John Romah  	vs.	Nils Klaper  	Player 1 Win
Wilson Badillo  	vs.	Eli Teed  	Player 2 Win
Cooper Templeton  	vs.	Luis Maderas  	Player 2 Win
Sean Davis  	vs.	Jesse Harper  	Player 2 Win
Chris Brummett  	vs.	Daniel Collett  	Player 1 Win
Chad Pennell  	vs.	Kevin Canales  	Player 1 Win
Shimon Bandiel  	vs.	Sam Sutherland  	Player 2 Win
Ian Smith  	vs.	Roger Bodee  	Player 1 Win
Robbert Valkeneers  	vs.	Matt Muus  	Player 2 Win
Travis Woodward  	vs.	Paul LE GOUEZ  	Player 1 Win
Tonin ''Nini'' Veshi  	vs.	Aidan O'Sullivan  	Player 1 Win
Lorenzo Brambilla Pisoni  	vs.	Dexter Canright  	Player 1 Win
Joseph Scalco  	vs.	Lee Kimball  	Player 1 Win
Alexander Hempelmann  	vs.	Erick Ortiz  	Player 1 Win
Devin Bell  	vs.	Jodey Burney  	Player 2 Win
RONNY MARTIN  	vs.	Christopher Yunck  	Player 2 Win
Joshua Kehe  	vs.	Dexter Phan  	Player 1 Win
Derek Copp  	vs.	Franche Tan  	Player 2 Win
Bryan Kong  	vs.	Dyllon Dietz  	Player 1 Win
Lucas Molho  	vs.	Eric Dauernnheim  	Player 2 Win
Dave Cordeiro  	vs.	Bastien Le Guen  	Player 2 Win
William Pearlman  	vs.	Carl Norman  	Player 2 Win
Michael Toryk  	vs.	George Ferris  	Player 1 Win
connor rooney  	vs.	Corey Waugh  	Player 2 Win
Patrick Shaw  	vs.	Randall Suliga  	Player 2 Win
Davide Abis  	vs.	Justin Liwag  	Player 1 Win
Julian Felix Flury  	vs.	Arkadiusz "Rasaad" Sioda  	Player 1 Win
The Better Johnson  	vs.	Fuzzy Delp  	Player 1 Win
Julian Sniffen  	vs.	Donald Kell  	Player 1 Win
Mathew Frye  	vs.	Alex Brown  	Player 1 Win
Nick Tucker  	vs.	Greg Mitchell  	Player 1 Win
Todd Rowe  	vs.	Nick Bova  	Player 1 Win
Steven Rodriguez  	vs.	Adam Tran  	Player 1 Win
Chenjun Liu  	vs.	Owen Young  	Player 1 Win
Chandler To  	vs.	Jonathen Byrd  	Player 1 Win
Aria How  	vs.	Matthew Terrell  	Player 1 Win
Daniel Rothhaar  	vs.	David Letourneau  	Player 1 Win
Mateusz Sass  	vs.	Jasiel Diez  	Player 1 Win
Elijah Flanders  	vs.	David Lee  	Player 2 Win
Tae Kim  	vs.	Jesus Garcia Gomez-Valades  	Player 2 Win
Jonathan Lemire  	vs.	Yuanji Li  	Player 2 Win
Rob Sheridan  	vs.	Grant Kern  	Player 1 Win
Tanya Wunder  	vs.	Jonas Stoberock  	Player 2 Win
Brandon Canedy  	vs.	Gordon Koh Koh  	Player 2 Win
Justin Sybrandt  	vs.	Cooper Pemelton  	Player 1 Win
Tristan Hanson  	vs.	Brandon Bianco  	Player 2 Win
Justin Rowland  	vs.	Robin Avenoso  	Player 2 Win
Anthony Chiechi  	vs.	Rylie Groff  	Player 1 Win
Matthew Puckett  	vs.	Bartosz Dominiak  	Player 2 Win
Andrew Blackwell  	vs.	Zach Allen  	Player 2 Win
Nathaniel Meserve  	vs.	Blake Lococo  	Player 1 Win
Scott Egan  	vs.	Tom Evans  	Player 2 Win
Ian Shaffer  	vs.	Kyle Meserve  	Player 2 Win
Guillem Las Heras Aixandri  	vs.	Ethan Bridges  	Player 2 Win
Marvin Dominguez  	vs.	Brandon Crawford  	Player 2 Win
Connor Bryant  	vs.	Mason Taylor  	Player 2 Win
Thomas Coleman  	vs.	William Bradshaw  	Player 2 Win
Daniel Wolff  	vs.	Andrew Wachter  	Player 1 Win
Thomas Hood  	vs.	Shane Martin  	Player 1 Win
Mariusz Suchanecki  	vs.	Rowsendo Nelson  	Player 1 Win
Elijah Calub  	vs.	Mark Tan  	Player 2 Win
Kyle Eckenrode  	vs.	Colton Miller  	Player 1 Win
Patrick Yoder  	vs.	Adam Fronsee  	Player 2 Win
Madison Theriault  	vs.	Justin Balanca-Hawkes  	Player 1 Win
Thomas Briggs  	vs.	Menion Croll  	Player 2 Win
Alex Sneed  	vs.	William Pate  	Player 1 Win
Dennis Zhang  	vs.	Nicholas Snyder  	Player 1 Win
Aiden Dee  	vs.	Ricky Perez  	Player 1 Win
Dmitry Sorokin  	vs.	Daniel Wolfe  	Player 1 Win
Phillip Manwaring  	vs.	Logan Perry  	Player 1 Win
Ovas Siddiqui  	vs.	Kent Summerour  	Player 2 Win
ry mo  	vs.	Tim Seib  	Player 1 Win
Gary White  	vs.	Sebastian Russell  	Player 2 Win
Brandon Fields  	vs.	Jordan Brengartner  	Player 1 Win
Ciro Gambone  	vs.	Jacob Balgoyen  	Player 2 Win
Norman Bayliss  	vs.	Sebastian Spicher  	Player 2 Win
Robert Alonso  	vs.	Haik Voskerchian  	Player 2 Win
Keith Milde  	vs.	Christian Gerdes  	Player 1 Win
Anastasia Benner  	vs.	Erick Boeder  	Player 1 Win
Bill Jargowsky  	vs.	Patrick Nelson  	Player 1 Win
Derek Chiu  	vs.	Jackie Rousseau  	Player 2 Win
Erik Johnson  	vs.	Zack Phillips  	Player 2 Win
Sean Biava  	vs.	Kyle Hebert  	Player 1 Win
Anthony Herzog  	vs.	Michael McDowell  	Player 1 Win
Nathan Gardner  	vs.	Matthew Halstad  	Player 1 Win
Blake Godenzi  	vs.	Jasper Mork  	Player 1 Win
Sean Fox  	vs.	Joshua Levy  	Player 1 Win
Andre Belote  	vs.	Matthew Durci  	Player 1 Win
Kyle Richards  	vs.	Tyler Wolford  	Player 1 Win
Aaron Guy  	vs.	Steven Nemeth  	Player 2 Win
joseph lawson  	vs.	Josef Mendez  	Player 2 Win
Nam Vo  	vs.	Michael Fay  	Player 1 Win
Joshua Korovesi  	vs.	Brandon Akers  	Player 2 Win
Daniel Warner  	vs.	Marco Jurakovich  	Player 2 Win
Michael Ribar  	vs.	Bruno Cracco  	Player 1 Win
Matthew Verderame  	vs.	Max Small  	Player 1 Win
Carter Barton  	vs.	Robert Postlewaite  	Player 1 Win
anthony Petrillo  	vs.	Leo Shea  	Player 2 Win
BRAD ALLRED  	vs.	Artie Hamelin  	Player 1 Win
Michael Collins  	vs.	Alex Broussard  	Player 1 Win
Connor Matza  	vs.	Nicholas Hoover  	Player 2 Win
Jonah Overholt  	vs.	James Smith  	Player 2 Win
BRENT ANDERSON  	vs.	Marcus Brown  	Player 1 Win
Philip Middleton  	vs.	Tristan Mitchell  	Player 2 Win
Joshua Freeland  	vs.	Bobby Jarboe  	Player 1 Win
Tho Bui  	vs.	Bryce Johnson  	Player 2 Win
James Warburton  	vs.	Dayna Hagewood  	Player 1 Win
Chris Legg  	vs.	Justin Hill  	Player 1 Win
Joshua Paris  	vs.	Jakub "Lemur" Siedlecki  	Player 2 Win
Ben Sharrin  	vs.	Ethan Mitchell  	Player 1 Win
Aidan Arruza  	vs.	Travis Reeder  	Player 1 Win
Kolbrun Palsdottir  	vs.	Lee Conner  	Player 1 Win
Eric Holmes  	vs.	Bryan Knecht  	Player 2 Win
Sam (Real) Yuen  	vs.	Donovan Wilcox  	Player 1 Win
Ian Olson  	vs.	Sasha Lang  	Player 1 Win
Luke Magnuson  	vs.	Felipe Costa Batista  	Player 1 Win
Derek Anderson  	vs.	Brian McLachlin  	Player 1 Win
Brandon Green  	vs.	Nicholas Mejac  	Player 2 Win
Luke Shinn  	vs.	Paulo Fernandes  	Player 1 Win
Adam Green  	vs.	Matt Jacobs  	Player 2 Win
Caleb Broussard  	vs.	Daniel Davila  	Player 2 Win
TUCKER CAMPBELL  	vs.	Holden Isaacs  	Player 2 Win
Kevin Set  	vs.	Michael Bell  	Player 2 Win
David Brannen  	vs.	Zoey Gerstner  	Player 1 Win
Andrew Melson  	vs.	Zackary Whitt  	Player 1 Win
Bryce Kesterson  	vs.	Chris Rowland  	Player 2 Win
Justin Matlack  	vs.	Jesse Machusak  	Player 1 Win
Jonathan Julian  	vs.	Michael Popowich  	Player 1 Win
Airton dos Santos Junior  	vs.	Ethan Kirychuk  	Player 1 Win
Abbas Dedanwala  	vs.	Connor Talty  	Player 1 Win
Tyler Kerch  	vs.	Quinn Wongkew  	Player 2 Win
Logan Petersen  	vs.	Mike Morelli  	Player 2 Win
Amber Zee  	vs.	Kyle Peterson  	Player 1 Win
westley nottingham  	vs.	Will Rea  	Player 2 Win
Charles Poe  	vs.	Katie Koslosky  	Player 2 Win
Charles Simmons  	vs.	Joseph Bowers  	Player 1 Win
Daniel Bellotti  	vs.	William Bodo  	Player 1 Win
Joshua Rath  	vs.	Ryan Nenninger  	Player 1 Win
Hendrik Wytze Kluitenberg  	vs.	Nigel Wunder  	Player 1 Win
Justin Addington  	vs.	Brandon Datwyler  	Player 2 Win
Pierre-Nicolas Perrin  	vs.	Alek Idol  	Draw
Dennis Pham  	vs.	Chris Kern  	Player 1 Win
Caleb Nelson  	vs.	Chad Allred  	Player 1 Win
Michael Pawlak  	vs.	Michael Cusick  	Player 2 Win
Lexie Klasing  	vs.	Skyler Cady  	Player 1 Win
John Powell  	vs.	Andrew Lundeen  	Player 2 Win
Aidan Kwasneski  	vs.	Jesse Shaw  	Player 1 Win
Tommy Golightly  	vs.	Jeff Okrasinski  	Player 2 Win
Caleb Zavits  	vs.	Nicholas Trotta  	Player 1 Win
Kevin Guinn  	vs.	Manuel Rosario  	Player 2 Win
Erick Lofton  	vs.	Eric Gorski  	Player 1 Win
Matt Mills  	vs.	Brandon Bowden  	Player 1 Win
Dakota Scales  	vs.	Gerald Camangon  	Player 2 Win
Lucas Codato Antonio Silva  	vs.	James Prince  	Player 1 Win
Jeffrey Lang  	vs.	Allison Oram  	Player 2 Win
Michael McDermott  	vs.	Jared Wyce  	Player 2 Win
James Tague  	vs.	Daniel Link  	Player 1 Win
Lindsey Thiele  	vs.	Brandan St. Amour  	Player 1 Win
Gabriel Rasicot  	vs.	Alex Yun  	Player 1 Win
Chase Reiser  	vs.	Logan Brushart  	Player 1 Win
Chad McKittrick  	vs.	Tatiana Parada  	Player 1 Win
Alexander Choiniere  	vs.	Ashley Babiarz  	Player 1 Win
Walker Stephens  	vs.	Kashiem Brown  	Player 1 Win
Justin Harris  	vs.	Andrew MacNamee  	Player 2 Win
#####
Matthew W  	vs.	nicolas Jamoulle  	Player 1 Win
Tee Thebeau  	vs.	Jeremy Langevin  	Player 1 Win
Daniel Correas  	vs.	Jacob Kissel  	Player 2 Win
Oliver Phi  	vs.	Andrew Nguyen  	Player 2 Win
Taylor Crawford  	vs.	Dylan Ashcraft  	Player 1 Win
Matt MacLeod  	vs.	Donovan van Beek  	Player 1 Win
Jack Stoney  	vs.	Jacob Clements  	Player 2 Win
Jeff Thompson  	vs.	Colin Swisher  	Player 2 Win
Marcelo Gazzaneo  	vs.	Daniel Rutkowski  	Player 2 Win
Jonathan Magnuson  	vs.	Timothy Long  	Player 1 Win
Lucas Bannigan  	vs.	Dave Lin  	Player 2 Win
Max Dieckmann  	vs.	Levi Rauch  	Player 1 Win
Emery Powell  	vs.	Paul Naughton  	Player 1 Win
John Colvin  	vs.	Fernando Caprino  	Player 2 Win
Tyler Brotton  	vs.	Aaron Grace  	Player 1 Win
Dan Mui  	vs.	Anthony DT Zichella  	Player 1 Win
David Trinh  	vs.	Gregory Patellis  	Player 1 Win
Austin Kim  	vs.	Zach Bunn  	Player 2 Win
Maciej Chmielewski  	vs.	David Reitenbach  	Player 2 Win
Brennan Tolnay  	vs.	Bradley Tashman  	Player 2 Win
Benjamin Hebert  	vs.	Gabe Sher  	Player 2 Win
Adam Jessell  	vs.	Piotr Krzempek  	Player 1 Win
Andrew Goodwin  	vs.	Isaac Rancic  	Player 2 Win
Matt Rogers  	vs.	Alexander Benton  	Player 1 Win
Justin Salmon  	vs.	Timothy Wells  	Player 1 Win
Darryl Thompson  	vs.	Luis Maderas  	Player 2 Win
James Adams  	vs.	Eric Cortez omana  	Player 1 Win
Philip Parker  	vs.	Martin Hechtberger  	Player 2 Win
Andrew Henderson  	vs.	Jonny Espejo  	Player 2 Win
DYLAN MANGINI  	vs.	Christopher Yunck  	Player 1 Win
Yan Garito  	vs.	Yuanji Li  	Player 1 Win
Jie ma  	vs.	Andrew Bryant  	Player 1 Win
Louis Solymos  	vs.	Timothy Scroggs  	Player 2 Win
Paul White  	vs.	Jacob Lantz  	Player 1 Win
Raj Parikh  	vs.	Aria How  	Player 1 Win
Joshua Lovell  	vs.	Sam Sutherland  	Player 2 Win
Philip van Donselaar  	vs.	Joshua Lau  	Player 2 Win
Jacob Baugh  	vs.	Michael Lynch  	Player 2 Win
Dylan Williamson  	vs.	Zachry Benz  	Player 1 Win
Nicholas Porter  	vs.	jamie bithell  	Player 1 Win
Jonathan Richards  	vs.	Brandon Bianco  	Player 2 Win
Michael Lau  	vs.	Ian Smith  	Player 1 Win
Jeremiah Gardner  	vs.	Nathan Crawford  	Player 2 Win
Damien Riggins  	vs.	Nick Tucker  	Player 1 Win
Corey Baker  	vs.	Vlastimil Martinek Jr.  	Player 2 Win
Justin Gottlieb  	vs.	Isaac Brooks  	Player 2 Win
Yuki Lee Bender  	vs.	ANDREW WEBBER  	Player 1 Win
Rafaelo "Ruffy" Sarmiento  	vs.	Steven Rodriguez  	Player 1 Win
Liam Trodden  	vs.	Randall Sims  	Player 2 Win
Michael DeBoard  	vs.	David Lee  	Player 2 Win
Thaminda Edirisooriya  	vs.	Matthew VanPatten  	Player 2 Win
Caleb Womack  	vs.	Bun Ar  	Player 2 Win
Chris Ray  	vs.	Sean Moyer  	Player 2 Win
Haukur Thor Buason  	vs.	Jonathan (chugs) Moore  	Player 2 Win
Merrick Kemp  	vs.	Carl Norman  	Player 1 Win
Peyton Sayasith  	vs.	Eli Teed  	Player 2 Win
Tanner Propst  	vs.	Bartosz Dominiak  	Player 2 Win
Dylan Myers  	vs.	Franche Tan  	Player 1 Win
Alex Ptak  	vs.	Majin Bae  	Player 1 Win
Jake Wenger  	vs.	Zach Allen  	Player 2 Win
Ren Fisk  	vs.	Johnny Lam  	Player 2 Win
Anthony Cerenzio  	vs.	Chris Brummett  	Player 1 Win
Nathanael Hunt  	vs.	Davide Abis  	Player 1 Win
Clay DeAngelis  	vs.	Tom Evans  	Player 1 Win
Matt Garner  	vs.	ryan moran  	Player 2 Win
Cole Pellatt  	vs.	Matt Muus  	Player 2 Win
nicklas starland  	vs.	Julian Sniffen  	Player 2 Win
George Rodger  	vs.	Mathew Frye  	Player 1 Win
John Romah  	vs.	Todd Rowe  	Player 1 Win
Adrian Słowiński  	vs.	Justin Sybrandt  	Player 1 Win
Chad Pennell  	vs.	Travis Woodward  	Player 1 Win
Thorbjørn Lind Jensen  	vs.	Jodey Burney  	Draw
Tonin ''Nini'' Veshi  	vs.	Lorenzo Brambilla Pisoni  	Player 1 Win
Joseph Scalco  	vs.	Jesus Garcia Gomez-Valades  	Player 2 Win
Alexander Hempelmann  	vs.	Bryan Kong  	Player 2 Win
Joshua Kehe  	vs.	Michael Toryk  	Player 1 Win
Jesse Harper  	vs.	The Better Johnson  	Player 1 Win
Julian Felix Flury  	vs.	Chandler To  	Player 1 Win
Bastien Le Guen  	vs.	Edward Knight  	Player 2 Win
Chenjun Liu  	vs.	Daniel Rothhaar  	Draw
Mateusz Sass  	vs.	Kyle Meserve  	Player 1 Win
Randall Suliga  	vs.	Eric Dauernnheim  	Player 1 Win
Rob Sheridan  	vs.	Corey Waugh  	Player 2 Win
Aidan Berkel  	vs.	Anthony Chiechi  	Player 1 Win
Gordon Koh Koh  	vs.	Nathaniel Meserve  	Player 2 Win
Nicholas Santa  	vs.	Robin Avenoso  	Player 1 Win
Jonas Stoberock  	vs.	Mateusz Jasiński  	Player 1 Win
Ryan Barnett  	vs.	Ethan Bridges  	Player 2 Win
Chuck Hutchins  	vs.	Daniel Davila  	Player 1 Win
Ian Daryl Bon  	vs.	James Warburton  	Player 1 Win
Joel Repta  	vs.	George Ferris  	Player 1 Win
Sam OByrne  	vs.	Sean Fox  	Player 2 Win
Chris Fazio  	vs.	Sean Biava  	Player 1 Win
Frank Karamaroudis  	vs.	Airton dos Santos Junior  	Player 1 Win
Joel Grizzelle  	vs.	Dennis Zhang  	Player 2 Win
Chris Martin  	vs.	Christian Weißling  	Player 1 Win
Leonardo Pessôa  	vs.	Nathan Gardner  	Player 1 Win
Fabio Rego  	vs.	Daniel Wolff  	Player 1 Win
Martin Schelasin  	vs.	Aidan O'Sullivan  	Player 2 Win
Ryan Thomas  	vs.	Nicholas Mejac  	Player 2 Win
Nicholas Costanzo  	vs.	Holden Isaacs  	Player 2 Win
Nils Klaper  	vs.	Lee Kimball  	Player 1 Win
Wilson Badillo  	vs.	Brett Merold  	Player 1 Win
Cooper Templeton  	vs.	Michael Ribar  	Player 1 Win
Sean Davis  	vs.	Dexter Phan  	Player 1 Win
Paul LE GOUEZ  	vs.	Aliasgar Dedanwala  	Player 1 Win
Shimon Bandiel  	vs.	Devin Bell  	Player 2 Win
Jonathan Walker  	vs.	Anthony Cicchinelli  	Player 2 Win
Robbert Valkeneers  	vs.	Jonathen Byrd  	Player 1 Win
Mae French  	vs.	Andrew Melson  	Player 2 Win
Erick Ortiz  	vs.	Madison Theriault  	Player 2 Win
Derek Copp  	vs.	Dyllon Dietz  	Player 2 Win
Zdeněk Matura  	vs.	Justin Rowland  	Player 1 Win
Dave Cordeiro  	vs.	Chris Rowland  	Player 1 Win
Lucas Molho  	vs.	Tony Mapelli  	Player 1 Win
William Pearlman  	vs.	Adam Fronsee  	Player 2 Win
Patrick Shaw  	vs.	Lee Maring  	Player 1 Win
connor rooney  	vs.	Alex Slotnick  	Player 1 Win
David Letourneau  	vs.	Arkadiusz "Rasaad" Sioda  	Player 2 Win
Jasiel Diez  	vs.	Abbas Dedanwala  	Player 1 Win
Elijah Flanders  	vs.	Haik Voskerchian  	Player 2 Win
Tae Kim  	vs.	Owen Young  	Player 2 Win
Kevin Canales  	vs.	Spencer Freeman  	Player 2 Win
Justin Liwag  	vs.	Thomas Hood  	Player 2 Win
Tanya Wunder  	vs.	Ian Olson  	Player 2 Win
Tristan Hanson  	vs.	Leo Shea  	Player 2 Win
Bryce Henschel  	vs.	Matthew Fay  	Player 1 Win
Alex Brown  	vs.	David Brannen  	Player 2 Win
Matthew Puckett  	vs.	Aiden Dee  	Player 1 Win
Matthew Terrell  	vs.	Mark Tan  	Player 2 Win
Andrew Blackwell  	vs.	Kent Summerour  	Player 1 Win
Adam Tran  	vs.	Sam (Real) Yuen  	Player 2 Win
Daniel Collett  	vs.	James Smith  	Player 2 Win
Michael Rutkowski  	vs.	Luke Shinn  	Player 1 Win
Donald Kell  	vs.	Nicholas Hoover  	Player 1 Win
Ian Shaffer  	vs.	Jackie Rousseau  	Player 1 Win
Kyle Thiele  	vs.	Andre Belote  	Player 2 Win
Guillem Las Heras Aixandri  	vs.	Michael Bell  	Player 1 Win
Cooper Pemelton  	vs.	Phillip Manwaring  	Player 2 Win
Greg Mitchell  	vs.	Nam Vo  	Draw
Kyle Eckenrode  	vs.	ry mo  	Player 1 Win
Alex Sneed  	vs.	Bryce Johnson  	Player 1 Win
Sebastian Spicher  	vs.	Carter Barton  	Player 1 Win
Dmitry Sorokin  	vs.	Keith Milde  	Player 1 Win
Brandon Fields  	vs.	Mason Taylor  	Player 2 Win
Bill Jargowsky  	vs.	Anastasia Benner  	Player 2 Win
Anthony Herzog  	vs.	Sebastian Russell  	Player 2 Win
Blake Godenzi  	vs.	Brandon Crawford  	Player 1 Win
Zack Phillips  	vs.	Michael Collins  	Player 1 Win
Kyle Richards  	vs.	Luke Magnuson  	Player 2 Win
Matthew Verderame  	vs.	Matt Jacobs  	Player 1 Win
Jacob Balgoyen  	vs.	Jakub "Lemur" Siedlecki  	Player 2 Win
BRAD ALLRED  	vs.	William Bradshaw  	Player 2 Win
BRENT ANDERSON  	vs.	Aidan Arruza  	Player 2 Win
Joshua Freeland  	vs.	Ben Sharrin  	Player 2 Win
Chris Legg  	vs.	Derek Anderson  	Player 2 Win
Tristan Mitchell  	vs.	Brandon Akers  	Player 2 Win
Kolbrun Palsdottir  	vs.	Bryan Knecht  	Player 2 Win
Marco Jurakovich  	vs.	Josef Mendez  	Player 2 Win
Steven Nemeth  	vs.	Menion Croll  	Player 1 Win
Justin Matlack  	vs.	Connor Talty  	Player 2 Win
Connor Bryant  	vs.	Justin Balanca-Hawkes  	Player 1 Win
Marvin Dominguez  	vs.	Felipe Costa Batista  	Player 1 Win
Elijah Calub  	vs.	Travis Reeder  	Player 2 Win
Thomas Coleman  	vs.	Dayna Hagewood  	Player 1 Win
Thomas Briggs  	vs.	Lee Conner  	Player 1 Win
Ovas Siddiqui  	vs.	Eric Holmes  	Player 2 Win
Gary White  	vs.	Lexie Klasing  	Player 2 Win
Ciro Gambone  	vs.	Zoey Gerstner  	Player 1 Win
Derek Chiu  	vs.	Nicholas Snyder  	Player 1 Win
Kyle Hebert  	vs.	Erick Lofton  	Player 2 Win
Patrick Nelson  	vs.	Ethan Mitchell  	Player 2 Win
joseph lawson  	vs.	Zackary Whitt  	Player 2 Win
Logan Perry  	vs.	Daniel Warner  	Player 2 Win
Michael McDowell  	vs.	Justin Hill  	Player 2 Win
Max Small  	vs.	Hendrik Wytze Kluitenberg  	Player 2 Win
anthony Petrillo  	vs.	Kevin Set  	Player 1 Win
Jonah Overholt  	vs.	Ricky Perez  	Player 2 Win
Connor Matza  	vs.	Donovan Wilcox  	Player 2 Win
Philip Middleton  	vs.	Joshua Rath  	Player 2 Win
Tho Bui  	vs.	Amber Zee  	Player 2 Win
Joshua Paris  	vs.	Aidan Kwasneski  	Player 2 Win
Bruno Cracco  	vs.	Daniel Bellotti  	Player 1 Win
Brian McLachlin  	vs.	Joshua Levy  	Player 1 Win
Brandon Green  	vs.	William Pate  	Player 2 Win
Paulo Fernandes  	vs.	Michael Fay  	Draw
Caleb Broussard  	vs.	Caleb Zavits  	Player 2 Win
TUCKER CAMPBELL  	vs.	Dennis Pham  	Player 1 Win
Tim Seib  	vs.	Jordan Brengartner  	Player 2 Win
Jesse Machusak  	vs.	Charles Simmons  	Player 1 Win
Christian Gerdes  	vs.	Jared Wyce  	Player 1 Win
Colton Miller  	vs.	Gerald Camangon  	Player 1 Win
Ethan Kirychuk  	vs.	Katie Koslosky  	Player 2 Win
Caleb Nelson  	vs.	Lucas Codato Antonio Silva  	Player 2 Win
Quinn Wongkew  	vs.	Matt Mills  	Player 1 Win
Andrew Lundeen  	vs.	Brandon Datwyler  	Player 1 Win
Will Rea  	vs.	Walker Stephens  	Player 1 Win
Michael Cusick  	vs.	Allison Oram  	Player 2 Win
Jeff Okrasinski  	vs.	James Tague  	Player 2 Win
Tyler Kerch  	vs.	Nicholas Trotta  	Player 2 Win
Charles Poe  	vs.	Daniel Link  	Player 2 Win
westley nottingham  	vs.	Alexander Choiniere  	Player 1 Win
Joseph Bowers  	vs.	Ryan Nenninger  	Player 2 Win
Pierre-Nicolas Perrin  	vs.	Jesse Shaw  	Player 1 Win
John Powell  	vs.	Nigel Wunder  	Player 2 Win
Kevin Guinn  	vs.	Lindsey Thiele  	Player 1 Win
Eric Gorski  	vs.	Gabriel Rasicot  	Player 2 Win
Skyler Cady  	vs.	Chad Allred  	Draw
Jeffrey Lang  	vs.	Kyle Peterson  	Player 2 Win
Michael McDermott  	vs.	Chad McKittrick  	Player 1 Win
Alek Idol  	vs.	Chase Reiser  	Player 2 Win
Logan Brushart  	vs.	Justin Harris  	Player 1 Win
Alex Yun  	vs.	Kashiem Brown  	Player 1 Win
Tatiana Parada  	vs.	Andrew MacNamee  	Player 2 Win
Ashley Babiarz  	vs.	None	Player 1 Win
#####
Tee Thebeau  	vs.	Matthew W  	Player 2 Win
Jacob Kissel  	vs.	Justin Salmon  	Player 2 Win
Jeremy Langevin  	vs.	Jacob Clements  	Player 2 Win
Oliver Phi  	vs.	Dave Lin  	Player 2 Win
nicolas Jamoulle  	vs.	Gabe Sher  	Player 1 Win
Daniel Correas  	vs.	Andrew Nguyen  	Player 1 Win
Taylor Crawford  	vs.	Max Dieckmann  	Player 1 Win
Matt MacLeod  	vs.	Jonathan Magnuson  	Player 1 Win
Emery Powell  	vs.	Zach Bunn  	Player 2 Win
Colin Swisher  	vs.	David Trinh  	Player 1 Win
Tyler Brotton  	vs.	Bradley Tashman  	Player 1 Win
Daniel Rutkowski  	vs.	Fernando Caprino  	Player 1 Win
Adam Jessell  	vs.	Matt Rogers  	Player 2 Win
Isaac Rancic  	vs.	David Reitenbach  	Player 2 Win
Jack Stoney  	vs.	Timothy Long  	Player 2 Win
Jeff Thompson  	vs.	Bartosz Dominiak  	Player 2 Win
Marcelo Gazzaneo  	vs.	George Rodger  	Player 1 Win
Lucas Bannigan  	vs.	Paul Naughton  	Player 2 Win
Donovan van Beek  	vs.	Piotr Krzempek  	Player 1 Win
John Colvin  	vs.	Michael Lau  	Player 1 Win
Dylan Ashcraft  	vs.	Alexander Benton  	Player 2 Win
Austin Kim  	vs.	Brandon Bianco  	Player 2 Win
Maciej Chmielewski  	vs.	Isaac Brooks  	Player 2 Win
Brennan Tolnay  	vs.	Nathanael Hunt  	Player 2 Win
Levi Rauch  	vs.	Mateusz Sass  	Player 2 Win
Gregory Patellis  	vs.	Jie ma  	Player 2 Win
Benjamin Hebert  	vs.	Jesse Harper  	Player 1 Win
Aaron Grace  	vs.	Julian Felix Flury  	Player 1 Win
Andrew Goodwin  	vs.	Zach Allen  	Player 1 Win
Anthony DT Zichella  	vs.	Jonny Espejo  	Player 2 Win
Timothy Wells  	vs.	Michael Lynch  	Player 1 Win
James Adams  	vs.	Randall Suliga  	Player 2 Win
DYLAN MANGINI  	vs.	Dylan Myers  	Player 1 Win
Yan Garito  	vs.	Nathaniel Meserve  	Player 1 Win
Raj Parikh  	vs.	Chad Pennell  	Player 1 Win
Timothy Scroggs  	vs.	Clay DeAngelis  	Player 2 Win
Paul White  	vs.	Matt Muus  	Player 2 Win
Dylan Williamson  	vs.	Damien Riggins  	Player 2 Win
Nicholas Porter  	vs.	Sam Sutherland  	Player 1 Win
Vlastimil Martinek Jr.  	vs.	Eli Teed  	Player 2 Win
Yuki Lee Bender  	vs.	John Romah  	Player 1 Win
Martin Hechtberger  	vs.	David Lee  	Player 1 Win
Rafaelo "Ruffy" Sarmiento  	vs.	Tonin ''Nini'' Veshi  	Player 2 Win
Merrick Kemp  	vs.	Adrian Słowiński  	Player 1 Win
Randall Sims  	vs.	Matthew VanPatten  	Player 1 Win
Alex Ptak  	vs.	Corey Waugh  	Player 1 Win
Anthony Cerenzio  	vs.	Bun Ar  	Player 2 Win
Jonathan (chugs) Moore  	vs.	Ethan Bridges  	Player 1 Win
ryan moran  	vs.	Sean Moyer  	Player 2 Win
Joshua Lau  	vs.	Nathan Crawford  	Player 2 Win
Bryan Kong  	vs.	Luis Maderas  	Player 1 Win
Joshua Kehe  	vs.	Julian Sniffen  	Player 2 Win
Aidan Berkel  	vs.	Jonas Stoberock  	Player 2 Win
Johnny Lam  	vs.	Nicholas Santa  	Player 1 Win
Edward Knight  	vs.	Jesus Garcia Gomez-Valades  	Player 1 Win
#####
Matthew W  	vs.	Matt MacLeod  	Player 1 Win
Tee Thebeau  	vs.	Colin Swisher  	Player 2 Win
Jacob Kissel  	vs.	Taylor Crawford  	Player 2 Win
nicolas Jamoulle  	vs.	David Reitenbach  	Player 2 Win
Daniel Correas  	vs.	Jacob Clements  	Player 2 Win
Tyler Brotton  	vs.	Matt Rogers  	Player 2 Win
Zach Bunn  	vs.	Justin Salmon  	Player 1 Win
Daniel Rutkowski  	vs.	Dave Lin  	Player 1 Win
Jeremy Langevin  	vs.	Emery Powell  	Player 2 Win
Oliver Phi  	vs.	Jie ma  	Player 2 Win
Jonathan Magnuson  	vs.	Edward Knight  	Player 1 Win
Max Dieckmann  	vs.	Jonathan (chugs) Moore  	Player 2 Win
David Trinh  	vs.	Yan Garito  	Player 2 Win
Andrew Nguyen  	vs.	Timothy Long  	Player 2 Win
Bradley Tashman  	vs.	John Colvin  	Player 1 Win
Fernando Caprino  	vs.	Johnny Lam  	Player 1 Win
Gabe Sher  	vs.	Merrick Kemp  	Player 2 Win
Adam Jessell  	vs.	Nicholas Porter  	Player 2 Win
Isaac Rancic  	vs.	Yuki Lee Bender  	Player 2 Win
Marcelo Gazzaneo  	vs.	DYLAN MANGINI  	Player 2 Win
Donovan van Beek  	vs.	Tonin ''Nini'' Veshi  	Player 1 Win
Paul Naughton  	vs.	Isaac Brooks  	Player 2 Win
Benjamin Hebert  	vs.	Brandon Bianco  	Player 1 Win
Aaron Grace  	vs.	Nathan Crawford  	Player 2 Win
Andrew Goodwin  	vs.	Bartosz Dominiak  	Player 1 Win
Alexander Benton  	vs.	Mateusz Sass  	Player 2 Win
Timothy Wells  	vs.	Raj Parikh  	Player 2 Win
Damien Riggins  	vs.	Martin Hechtberger  	Player 1 Win
Jonny Espejo  	vs.	Sean Moyer  	Player 2 Win
Randall Sims  	vs.	Clay DeAngelis  	Player 1 Win
Alex Ptak  	vs.	Nathanael Hunt  	Player 1 Win
Bryan Kong  	vs.	Bun Ar  	Player 2 Win
Eli Teed  	vs.	Julian Sniffen  	Player 1 Win
Randall Suliga  	vs.	Matt Muus  	Player 1 Win
Jonas Stoberock  	vs.	Joshua Kehe  	Player 1 Win
Jeff Thompson  	vs.	ryan moran  	Player 1 Win
Jack Stoney  	vs.	Brennan Tolnay  	Player 2 Win
Lucas Bannigan  	vs.	Paul White  	Player 2 Win
Dylan Ashcraft  	vs.	Timothy Scroggs  	Player 1 Win
Austin Kim  	vs.	Michael Lynch  	Player 1 Win
Maciej Chmielewski  	vs.	Corey Waugh  	Player 2 Win
Levi Rauch  	vs.	Julian Felix Flury  	Player 2 Win
Gregory Patellis  	vs.	Jesus Garcia Gomez-Valades  	Player 1 Win
Piotr Krzempek  	vs.	Ethan Bridges  	Player 1 Win
Anthony DT Zichella  	vs.	Jesse Harper  	Player 2 Win
James Adams  	vs.	Aidan Berkel  	Player 2 Win
Dylan Williamson  	vs.	Dylan Myers  	Player 2 Win
Michael Lau  	vs.	Vlastimil Martinek Jr.  	Player 1 Win
Rafaelo "Ruffy" Sarmiento  	vs.	Anthony Cerenzio  	Player 1 Win
Matthew VanPatten  	vs.	Nicholas Santa  	Player 1 Win
George Rodger  	vs.	Luis Maderas  	Player 1 Win
John Romah  	vs.	Nathaniel Meserve  	Player 2 Win
Adrian Słowiński  	vs.	None	Player 1 Win
Chad Pennell  	vs.	Sam Sutherland  	Player 2 Win
David Lee  	vs.	Zach Allen  	Draw
#####
Matthew W  	vs.	Daniel Rutkowski  	Player 1 Win
Taylor Crawford  	vs.	David Reitenbach  	Player 1 Win
Colin Swisher  	vs.	Zach Bunn  	Player 2 Win
Matt Rogers  	vs.	Jacob Clements  	Player 1 Win
Tee Thebeau  	vs.	Fernando Caprino  	Player 1 Win
Jacob Kissel  	vs.	Benjamin Hebert  	Player 1 Win
nicolas Jamoulle  	vs.	Sean Moyer  	Player 1 Win
Daniel Correas  	vs.	Jonas Stoberock  	Player 2 Win
Matt MacLeod  	vs.	Merrick Kemp  	Player 2 Win
Tyler Brotton  	vs.	Timothy Long  	Player 1 Win
Dave Lin  	vs.	Eli Teed  	Player 1 Win
Justin Salmon  	vs.	Donovan van Beek  	Player 1 Win
Jonathan Magnuson  	vs.	Bun Ar  	Player 2 Win
Emery Powell  	vs.	Alex Ptak  	Player 1 Win
Bradley Tashman  	vs.	Yan Garito  	Player 1 Win
Andrew Goodwin  	vs.	Randall Sims  	Player 2 Win
DYLAN MANGINI  	vs.	Damien Riggins  	Player 2 Win
Jie ma  	vs.	Yuki Lee Bender  	Player 2 Win
Raj Parikh  	vs.	Nicholas Porter  	Player 1 Win
Jonathan (chugs) Moore  	vs.	Randall Suliga  	Player 1 Win
Isaac Brooks  	vs.	Mateusz Sass  	Player 2 Win
Nathan Crawford  	vs.	Brandon Bianco  	Player 1 Win
Jeremy Langevin  	vs.	Dylan Ashcraft  	Player 2 Win
Oliver Phi  	vs.	Dylan Myers  	Player 1 Win
Max Dieckmann  	vs.	Adrian Słowiński  	Player 1 Win
David Trinh  	vs.	Paul Naughton  	Player 1 Win
Andrew Nguyen  	vs.	Matthew VanPatten  	Player 2 Win
Gabe Sher  	vs.	Martin Hechtberger  	Player 1 Win
Adam Jessell  	vs.	Edward Knight  	Player 1 Win
Isaac Rancic  	vs.	Timothy Wells  	Player 1 Win
Marcelo Gazzaneo  	vs.	Nathanael Hunt  	Player 1 Win
John Colvin  	vs.	Alexander Benton  	Player 2 Win
Aaron Grace  	vs.	Jesse Harper  	Player 1 Win
Jonny Espejo  	vs.	Michael Lau  	Player 2 Win
Clay DeAngelis  	vs.	Tonin ''Nini'' Veshi  	Player 2 Win
Bryan Kong  	vs.	Rafaelo "Ruffy" Sarmiento  	Player 1 Win
Julian Sniffen  	vs.	Piotr Krzempek  	Player 1 Win
Matt Muus  	vs.	Johnny Lam  	Player 1 Win
Bartosz Dominiak  	vs.	George Rodger  	Player 2 Win
Jeff Thompson  	vs.	Julian Felix Flury  	Player 2 Win
Austin Kim  	vs.	Sam Sutherland  	Player 2 Win
Brennan Tolnay  	vs.	Paul White  	Player 2 Win
Gregory Patellis  	vs.	Nathaniel Meserve  	Player 1 Win
Aidan Berkel  	vs.	Corey Waugh  	Player 1 Win
Jack Stoney  	vs.	Jesus Garcia Gomez-Valades  	Player 2 Win
Lucas Bannigan  	vs.	Luis Maderas  	Player 2 Win
Maciej Chmielewski  	vs.	David Lee  	Player 1 Win
Levi Rauch  	vs.	Dylan Williamson  	Player 2 Win
Anthony DT Zichella  	vs.	Michael Lynch  	Player 1 Win
James Adams  	vs.	Anthony Cerenzio  	Player 1 Win
Timothy Scroggs  	vs.	ryan moran  	Player 2 Win
Vlastimil Martinek Jr.  	vs.	Zach Allen  	Player 2 Win
John Romah  	vs.	Joshua Kehe  	Player 2 Win
Nicholas Santa  	vs.	Ethan Bridges  	Player 2 Win
#####
Matthew W  	vs.	Matt Rogers  	Player 2 Win
Taylor Crawford  	vs.	Zach Bunn  	Player 1 Win
Colin Swisher  	vs.	Emery Powell  	Player 1 Win
Daniel Rutkowski  	vs.	Jacob Clements  	Player 2 Win
David Reitenbach  	vs.	Randall Sims  	Player 2 Win
Tee Thebeau  	vs.	Bun Ar  	Player 2 Win
Jacob Kissel  	vs.	nicolas Jamoulle  	Player 1 Win
Tyler Brotton  	vs.	Nathan Crawford  	Player 2 Win
Dave Lin  	vs.	Justin Salmon  	Player 1 Win
Bradley Tashman  	vs.	Raj Parikh  	Player 2 Win
Damien Riggins  	vs.	Yuki Lee Bender  	Player 2 Win
Merrick Kemp  	vs.	Jonas Stoberock  	Player 1 Win
Jonathan (chugs) Moore  	vs.	Mateusz Sass  	Player 1 Win
Daniel Correas  	vs.	Isaac Rancic  	Player 2 Win
Matt MacLeod  	vs.	Fernando Caprino  	Player 1 Win
Jonathan Magnuson  	vs.	Michael Lau  	Player 1 Win
Donovan van Beek  	vs.	David Trinh  	Player 1 Win
Timothy Long  	vs.	Paul White  	Player 1 Win
Benjamin Hebert  	vs.	Aidan Berkel  	Player 2 Win
Andrew Goodwin  	vs.	Gabe Sher  	Player 1 Win
DYLAN MANGINI  	vs.	Adam Jessell  	Player 1 Win
Yan Garito  	vs.	Sean Moyer  	Player 1 Win
Jie ma  	vs.	Sam Sutherland  	Player 2 Win
Nicholas Porter  	vs.	Eli Teed  	Player 2 Win
Alex Ptak  	vs.	Oliver Phi  	Player 1 Win
Isaac Brooks  	vs.	Julian Sniffen  	Player 1 Win
Randall Suliga  	vs.	Gregory Patellis  	Player 1 Win
Max Dieckmann  	vs.	Dylan Ashcraft  	Player 1 Win
Marcelo Gazzaneo  	vs.	Bryan Kong  	Player 2 Win
Aaron Grace  	vs.	George Rodger  	Player 2 Win
Alexander Benton  	vs.	Matthew VanPatten  	Player 1 Win
Tonin ''Nini'' Veshi  	vs.	Matt Muus  	Player 1 Win
Julian Felix Flury  	vs.	Martin Hechtberger  	Player 1 Win
Jeremy Langevin  	vs.	Anthony DT Zichella  	Player 2 Win
Andrew Nguyen  	vs.	Nathaniel Meserve  	Player 1 Win
John Colvin  	vs.	Timothy Wells  	Player 2 Win
Paul Naughton  	vs.	Maciej Chmielewski  	Player 2 Win
Jonny Espejo  	vs.	Dylan Williamson  	Player 2 Win
Clay DeAngelis  	vs.	Adrian Słowiński  	Player 1 Win
Johnny Lam  	vs.	Brennan Tolnay  	Player 1 Win
Edward Knight  	vs.	Joshua Kehe  	Player 2 Win
Jeff Thompson  	vs.	Zach Allen  	Player 1 Win
Austin Kim  	vs.	James Adams  	Player 2 Win
Rafaelo "Ruffy" Sarmiento  	vs.	Ethan Bridges  	Player 1 Win
Jesse Harper  	vs.	ryan moran  	Player 2 Win
Corey Waugh  	vs.	Jesus Garcia Gomez-Valades  	Player 1 Win
Luis Maderas  	vs.	Vlastimil Martinek Jr.  	Player 1 Win
Levi Rauch  	vs.	Timothy Scroggs  	Player 1 Win
Anthony Cerenzio  	vs.	Nicholas Santa  	Player 2 Win
John Romah  	vs.	David Lee  	Player 2 Win
#####
Matthew W  	vs.	Taylor Crawford  	Player 2 Win
Matt Rogers  	vs.	Jonathan (chugs) Moore  	Player 1 Win
Zach Bunn  	vs.	Nathan Crawford  	Player 1 Win
Colin Swisher  	vs.	Bun Ar  	Player 2 Win
Jacob Clements  	vs.	Jacob Kissel  	Player 2 Win
Dave Lin  	vs.	Yuki Lee Bender  	Player 1 Win
Raj Parikh  	vs.	Merrick Kemp  	Player 2 Win
Randall Sims  	vs.	Justin Salmon  	Player 1 Win
Daniel Rutkowski  	vs.	Emery Powell  	Player 2 Win
David Reitenbach  	vs.	Bradley Tashman  	Player 1 Win
Tee Thebeau  	vs.	Andrew Goodwin  	Player 1 Win
nicolas Jamoulle  	vs.	Matt MacLeod  	Player 2 Win
Tyler Brotton  	vs.	DYLAN MANGINI  	Player 1 Win
Damien Riggins  	vs.	Isaac Rancic  	Player 1 Win
Mateusz Sass  	vs.	Randall Suliga  	Player 1 Win
Jonas Stoberock  	vs.	Timothy Long  	Player 2 Win
Jonathan Magnuson  	vs.	George Rodger  	Player 2 Win
Donovan van Beek  	vs.	Sam Sutherland  	Player 1 Win
Yan Garito  	vs.	Aidan Berkel  	Player 1 Win
Alex Ptak  	vs.	Eli Teed  	Player 1 Win
Isaac Brooks  	vs.	Max Dieckmann  	Player 2 Win
Alexander Benton  	vs.	Tonin ''Nini'' Veshi  	Player 1 Win
Bryan Kong  	vs.	Julian Felix Flury  	Player 1 Win
Daniel Correas  	vs.	Benjamin Hebert  	Player 2 Win
Fernando Caprino  	vs.	Aaron Grace  	Player 1 Win
Jie ma  	vs.	Johnny Lam  	Player 1 Win
Sean Moyer  	vs.	Jeff Thompson  	Player 1 Win
Oliver Phi  	vs.	Clay DeAngelis  	Player 2 Win
David Trinh  	vs.	Gabe Sher  	Player 1 Win
Adam Jessell  	vs.	Paul White  	Player 1 Win
Marcelo Gazzaneo  	vs.	Luis Maderas  	Player 1 Win
Julian Sniffen  	vs.	Andrew Nguyen  	Player 1 Win
Matt Muus  	vs.	Michael Lau  	Player 1 Win
Dylan Ashcraft  	vs.	Maciej Chmielewski  	Player 2 Win
Gregory Patellis  	vs.	James Adams  	Player 2 Win
Matthew VanPatten  	vs.	ryan moran  	Player 2 Win
Timothy Wells  	vs.	Rafaelo "Ruffy" Sarmiento  	Player 2 Win
Corey Waugh  	vs.	Anthony DT Zichella  	Player 2 Win
Dylan Williamson  	vs.	Joshua Kehe  	Player 1 Win
John Colvin  	vs.	Ethan Bridges  	Player 1 Win
Paul Naughton  	vs.	Nathaniel Meserve  	Player 2 Win
Edward Knight  	vs.	David Lee  	Player 1 Win
Austin Kim  	vs.	Vlastimil Martinek Jr.  	Player 1 Win
Adrian Słowiński  	vs.	Levi Rauch  	Player 2 Win
Jesus Garcia Gomez-Valades  	vs.	Nicholas Santa  	Player 1 Win
Anthony Cerenzio  	vs.	John Romah  	Player 1 Win
#####
Taylor Crawford  	vs.	Randall Sims  	Player 1 Win
Zach Bunn  	vs.	Jacob Kissel  	Player 1 Win
Matthew W  	vs.	Dave Lin  	Player 2 Win
Matt Rogers  	vs.	Merrick Kemp  	Player 2 Wi
#####
Taylor Crawford  	vs.	Zach Bunn  	Player 1 Win
Dave Lin  	vs.	Merrick Kemp  	Player 2 Win
#####
Taylor Crawford  	vs.	Merrick Kemp  	Player 2 Win
